,student_id,pauses,unique_patterns_count,total_values_count,total_non_zero_values_count,duplicates
0,1,1,5,12,6,1
1,2,17,26,28,28,2
2,3,9,38,48,47,9
3,4,7,54,64,62,8
4,5,6,48,63,62,14
5,6,11,37,43,41,4
6,7,14,25,34,30,5
7,8,22,27,28,28,1
8,9,20,30,39,38,8
9,10,15,37,43,39,2
10,11,9,19,22,22,3
11,12,18,30,32,31,1
12,13,2,9,24,19,10
13,16,7,43,54,52,9
14,17,17,37,46,45,8
15,18,13,23,52,29,6
16,21,18,36,42,40,4
17,25,24,22,27,25,3
18,26,20,20,21,21,1
19,29,15,22,23,23,1
20,30,9,42,55,54,12
21,32,10,18,23,22,4
22,33,16,32,33,32,0
23,35,17,24,26,26,2
24,36,8,42,50,48,6
25,37,14,31,33,32,1
26,39,15,37,41,40,3
27,40,9,19,24,23,4
28,41,11,33,52,43,10
29,45,17,26,32,30,4
30,49,12,11,15,12,1
31,51,2,13,24,24,11
32,54,14,40,45,43,3
33,55,26,42,84,55,13
34,56,4,48,56,55,7
35,58,13,36,43,43,7
36,64,21,18,20,20,2
37,65,5,2,15,9,7
38,66,9,36,38,38,2
39,67,11,43,44,44,1
40,68,17,32,36,36,4
41,69,8,18,113,67,49
42,70,15,23,38,26,3
43,71,16,16,18,17,1
44,73,7,46,51,50,4
45,75,16,38,40,40,2
46,77,13,33,51,41,8
47,79,13,12,13,13,1
48,80,12,40,53,48,8
49,81,8,50,54,54,4
50,82,16,32,38,38,6
51,83,9,35,45,43,8
52,85,10,42,44,44,2
53,86,9,51,56,54,3
54,87,11,33,42,37,4
55,95,15,33,43,41,8
56,101,16,26,27,27,1
57,103,10,16,29,26,10
58,105,10,25,31,26,1
59,108,18,26,34,33,7
60,109,18,28,33,31,3
61,110,14,44,47,47,3
62,111,15,30,35,33,3
63,112,9,41,53,49,8
64,115,19,24,26,26,2
65,116,18,23,25,25,2
66,117,14,27,32,30,3
67,118,16,39,44,44,5
68,119,9,42,61,60,18
69,121,11,33,38,37,4
70,122,7,32,53,48,16
71,123,12,12,27,16,4
72,127,9,40,48,47,7
73,129,6,44,55,53,9
74,130,8,38,45,45,7
75,131,7,47,56,51,4
76,132,18,21,42,25,4
77,133,13,41,42,42,1
78,135,18,24,35,29,5
79,136,16,15,16,15,0
80,140,3,1,4,1,0
81,141,10,45,49,47,2
82,145,16,18,58,26,8
83,146,11,51,56,56,5
84,150,14,31,38,34,3
85,158,9,44,54,53,9
86,159,15,35,44,35,0
87,160,6,44,51,51,7
88,163,9,44,47,47,3
89,172,17,25,28,28,3
90,175,15,22,29,23,1
91,176,14,29,38,36,7
92,178,14,45,56,53,8
93,179,22,39,40,40,1
94,180,22,21,26,25,4
95,185,6,44,52,51,7
96,187,10,10,10,10,0
97,191,15,16,19,18,2
98,196,11,9,12,10,1
99,200,4,51,57,54,3
100,204,3,2,3,2,0
101,206,5,53,65,61,8
102,208,13,38,47,45,7
103,209,22,18,23,23,5
104,210,15,18,23,20,2
105,211,15,28,38,33,5
106,212,8,45,51,51,6
107,214,9,35,38,36,1
108,218,10,46,53,51,5
109,222,22,29,31,30,1
110,224,10,5,76,68,63
111,227,14,30,30,30,0
112,228,17,30,35,34,4
113,230,11,43,48,46,3
114,235,7,49,53,53,4
115,236,16,35,35,35,0
116,237,24,23,23,23,0
117,239,17,25,45,34,9
118,243,11,21,40,39,18
119,246,18,32,37,36,4
120,247,11,37,70,43,6
121,248,14,31,48,42,11
122,250,11,33,40,36,3
123,251,12,39,41,41,2
124,252,15,38,40,40,2
125,253,12,9,28,28,19
126,254,12,37,42,42,5
127,255,21,28,33,31,3
128,256,11,34,46,41,7
129,258,5,42,57,56,14
130,260,7,34,45,43,9
131,261,6,48,51,51,3
132,264,10,22,44,30,8
133,266,13,32,36,35,3
134,268,20,14,42,26,12
135,273,11,20,23,22,2
136,274,17,21,25,24,3
137,275,5,50,55,54,4
138,277,12,37,56,56,19
139,279,13,27,30,27,0
140,280,17,31,34,33,2
141,281,21,29,34,30,1
142,282,13,32,48,36,4
143,284,20,21,21,21,0
144,288,10,32,41,38,6
145,293,7,49,56,54,5
146,296,15,27,34,31,4
147,297,18,17,30,23,6
148,298,15,22,26,25,3
149,300,12,35,38,36,1
150,301,18,32,38,35,3
151,304,18,21,23,22,1
152,305,15,35,36,35,0
153,306,9,21,22,21,0
154,309,12,2,12,11,9
155,310,3,50,57,56,6
156,312,12,27,50,32,5
157,313,12,37,49,47,10
158,316,9,7,10,8,1
159,317,11,33,40,39,6
160,320,8,8,8,8,0
161,323,11,40,57,46,6
162,326,10,38,48,47,9
163,329,4,33,35,34,1
164,330,9,40,52,51,11
165,332,16,14,15,15,1
166,335,12,36,50,45,9
167,336,13,45,54,50,5
168,341,15,36,40,39,3
169,343,13,29,43,39,10
170,344,18,26,32,31,5
171,345,14,32,39,39,7
172,347,16,34,40,38,4
173,348,21,32,38,38,6
174,349,22,25,27,26,1
175,352,15,29,47,37,8
176,353,19,20,20,20,0
177,354,20,30,33,33,3
178,356,12,42,48,47,5
179,357,13,27,28,28,1
180,359,19,27,30,29,2
181,361,14,45,48,46,1
182,362,14,29,38,33,4
183,364,9,49,56,54,5
184,373,8,47,49,49,2
185,376,14,22,23,23,1
186,378,14,26,36,34,8
187,379,11,41,47,45,4
188,382,21,37,40,39,2
189,383,17,18,19,18,0
190,385,11,26,26,26,0
191,386,13,27,47,37,10
192,387,9,33,42,39,6
193,395,7,34,41,38,4
194,396,15,40,47,44,4
195,398,15,30,44,38,8
196,401,4,31,49,49,18
197,402,19,30,32,32,2
198,403,14,34,45,37,3
199,404,19,20,25,25,5
200,406,15,15,37,25,10
201,409,19,18,20,18,0
202,410,20,27,29,29,2
203,413,11,34,36,36,2
204,414,5,49,55,54,5
205,417,18,29,37,33,4
206,418,18,27,31,31,4
207,419,12,23,27,24,1
208,420,15,29,33,33,4
209,421,24,28,28,28,0
210,422,10,26,31,30,4
211,426,11,33,37,37,4
212,428,15,38,42,41,3
213,430,15,15,17,17,2
214,434,12,34,47,45,11
215,435,12,37,43,42,5
216,437,4,46,55,53,7
217,439,7,26,29,27,1
218,440,19,32,36,35,3
219,441,20,21,25,23,2
220,443,18,23,40,32,9
221,444,17,22,29,28,6
222,445,20,21,22,22,1
223,450,11,33,41,41,8
224,453,9,47,56,55,8
225,454,7,53,62,59,6
226,455,12,38,43,40,2
227,457,8,44,53,53,9
228,458,8,44,47,47,3
229,459,13,12,16,14,2
230,464,21,20,24,22,2
231,465,17,28,54,30,2
232,467,13,28,32,31,3
233,469,20,21,22,21,0
234,472,18,24,33,29,5
235,480,13,42,44,43,1
236,482,16,42,50,48,6
237,483,16,17,23,20,3
238,485,9,41,51,47,6
239,486,14,32,45,32,0
240,489,18,34,37,37,3
241,491,10,36,43,41,5
242,492,18,31,35,34,3
243,496,19,29,34,33,4
244,499,12,27,63,47,20
245,502,12,41,42,42,1
246,504,15,35,37,37,2
247,506,11,32,46,41,9
248,507,9,39,43,43,4
249,509,14,41,45,44,3
250,510,14,28,31,31,3
251,511,8,41,47,43,2
252,512,16,15,20,17,2
253,513,10,41,46,45,4
254,514,11,17,23,20,3
255,515,23,28,32,30,2
256,516,6,36,58,58,22
257,517,21,30,31,31,1
258,518,23,25,31,30,5
259,519,8,43,51,48,5
260,522,21,27,34,31,4
261,523,6,41,53,47,6
262,528,16,30,45,39,9
263,529,8,42,48,47,5
264,531,9,46,54,52,6
265,532,13,27,29,29,2
266,533,21,26,32,32,6
267,536,11,25,34,32,7
268,538,13,38,53,44,6
269,541,8,39,47,47,8
270,545,14,28,31,30,2
271,546,13,23,27,26,3
272,550,15,30,44,38,8
273,551,10,34,55,45,11
274,554,10,44,46,45,1
275,555,13,30,45,41,11
276,556,17,21,25,22,1
277,560,12,22,43,39,17
278,563,22,28,33,30,2
279,566,15,30,36,35,5
280,568,16,20,23,22,2
281,571,19,11,24,22,11
282,572,16,24,24,24,0
283,577,17,14,19,16,2
284,582,13,37,42,41,4
285,583,17,28,33,33,5
286,585,6,5,5,5,0
287,588,14,35,41,36,1
288,590,14,23,27,26,3
289,594,9,42,59,57,15
290,595,11,44,48,47,3
291,596,13,38,43,41,3
292,598,18,25,28,28,3
293,599,6,19,22,22,3
294,600,20,19,20,20,1
295,601,18,16,18,17,1
296,605,15,35,40,38,3
297,607,14,24,32,28,4
298,613,6,49,58,57,8
299,614,14,33,36,34,1
300,615,10,31,36,36,5
301,618,7,40,57,50,10
302,621,14,20,26,22,2
303,624,18,14,17,15,1
304,625,21,23,27,27,4
305,627,12,36,40,40,4
306,628,12,6,11,11,5
307,629,10,3,26,4,1
308,630,25,28,32,31,3
309,631,15,29,31,30,1
310,632,2,56,64,61,5
311,633,17,31,33,33,2
312,636,18,36,38,38,2
313,638,12,33,37,37,4
314,639,16,15,28,21,6
315,640,14,38,46,43,5
316,641,12,32,38,38,6
317,644,17,28,28,28,0
318,645,8,41,47,45,4
319,647,17,29,30,29,0
320,648,11,45,48,46,1
321,649,9,41,49,47,6
322,650,8,36,41,41,5
323,651,4,53,76,60,7
324,652,21,19,21,19,0
325,653,19,31,36,35,4
326,654,9,43,57,52,9
327,655,16,15,17,16,1
328,656,14,13,14,14,1
329,662,7,35,39,39,4
330,663,19,29,33,33,4
331,665,13,24,26,26,2
332,666,17,18,23,21,3
333,667,9,36,48,44,8
334,669,10,6,38,22,16
335,675,8,43,52,49,6
336,677,11,9,10,10,1
337,678,8,54,54,54,0
338,680,14,22,29,29,7
339,682,11,18,28,19,1
340,683,13,30,54,45,15
341,688,17,20,20,20,0
342,689,12,31,37,32,1
343,697,7,31,61,33,2
344,698,9,24,40,30,6
345,700,9,38,50,50,12
346,702,10,23,39,36,13
347,704,14,37,44,42,5
348,706,21,27,33,33,6
349,708,6,51,62,59,8
350,710,16,41,47,44,3
351,712,14,36,39,39,3
352,713,6,21,41,24,3
353,714,18,37,44,43,6
354,716,12,28,31,31,3
355,724,7,47,55,53,6
356,726,21,38,40,40,2
357,727,18,22,28,26,4
358,729,20,24,27,26,2
359,730,3,49,59,56,7
360,731,18,37,46,42,5
361,732,14,21,24,23,2
362,739,10,38,56,52,14
363,741,14,27,35,30,3
364,742,18,20,24,20,0
365,743,10,37,43,37,0
366,748,31,25,164,27,2
367,749,14,10,38,20,10
368,751,21,31,36,34,3
369,752,20,21,29,25,4
370,753,8,33,39,38,5
371,755,14,18,21,21,3
372,764,13,42,48,48,6
373,770,13,3,13,10,7
374,773,12,25,35,31,6
375,775,4,17,19,17,0
376,779,14,23,34,23,0
377,780,18,27,35,32,5
378,782,8,14,29,28,14
379,784,12,22,28,26,4
380,785,20,31,45,45,14
381,786,7,43,52,51,8
382,790,16,35,36,35,0
383,797,15,9,15,14,5
384,799,11,34,40,37,3
385,800,12,40,41,40,0
386,801,17,20,33,24,4
387,805,14,13,17,16,3
388,807,9,48,56,53,5
389,811,7,50,57,56,6
390,813,17,32,38,35,3
391,817,13,39,43,43,4
392,818,18,31,32,32,1
393,819,9,37,51,51,14
394,820,11,35,49,45,10
395,823,5,9,15,12,3
396,824,23,24,27,27,3
397,825,21,33,35,34,1
398,832,8,46,50,49,3
399,833,12,20,20,20,0
400,834,12,29,37,35,6
401,837,15,20,24,22,2
402,840,11,31,41,33,2
403,841,15,32,35,35,3
404,843,13,21,25,22,1
405,844,16,17,20,18,1
406,845,18,26,31,31,5
407,847,14,37,44,40,3
408,850,8,46,51,51,5
409,851,18,35,42,38,3
410,852,10,40,51,47,7
411,856,10,18,20,19,1
412,858,18,21,32,26,5
413,861,2,51,62,59,8
414,865,20,36,37,37,1
415,867,19,19,22,22,3
416,869,19,25,29,29,4
417,870,12,40,54,52,12
418,872,11,36,37,37,1
419,874,16,39,49,47,8
420,877,15,35,39,38,3
421,879,93,6,209,17,11
422,882,10,50,58,57,7
423,884,12,34,38,37,3
424,885,11,24,30,30,6
425,886,21,29,33,32,3
426,889,20,25,31,31,6
427,893,20,20,23,22,2
428,898,17,16,29,19,3
429,899,10,36,45,41,5
430,901,19,23,26,25,2
431,902,14,17,35,18,1
432,903,11,23,33,29,6
433,904,6,41,45,44,3
434,905,18,24,37,36,12
435,907,11,39,43,43,4
436,912,16,18,18,18,0
437,916,7,45,66,65,20
438,919,20,23,28,28,5
439,922,9,35,39,38,3
440,923,8,34,36,35,1
441,924,13,29,35,35,6
442,925,22,20,28,23,3
443,930,19,22,23,22,0
444,937,8,24,30,30,6
445,938,8,39,44,43,4
446,944,8,40,49,48,8
447,946,11,32,40,36,4
448,947,18,16,17,17,1
449,948,10,39,42,41,2
450,949,14,33,37,36,3
451,950,9,23,24,24,1
452,959,17,32,36,36,4
453,961,14,31,39,37,6
454,963,20,24,28,27,3
455,967,15,19,26,19,0
456,969,10,4,13,4,0
457,970,10,49,60,60,11
458,971,20,35,38,38,3
459,972,12,31,51,41,10
460,974,15,27,31,30,3
461,977,17,30,32,32,2
462,980,9,27,29,27,0
463,984,14,24,25,24,0
464,985,19,26,27,27,1
465,989,4,32,46,37,5
466,994,19,34,41,39,5
467,997,16,38,42,42,4
468,1000,8,34,40,39,5
469,1004,16,35,35,35,0
470,1006,16,32,35,35,3
471,1008,12,14,42,23,9
472,1009,24,24,26,26,2
473,1011,10,29,46,40,11
474,1014,16,15,15,15,0
475,1015,17,26,27,26,0
476,1018,17,34,36,35,1
477,1019,12,24,30,28,4
478,1020,9,38,48,43,5
479,1022,16,28,57,40,12
480,1024,15,32,39,38,6
481,1027,19,28,41,30,2
482,1029,12,36,39,39,3
483,1030,10,28,34,33,5
484,1031,16,15,37,27,12
485,1035,9,42,50,49,7
486,1037,15,27,39,36,9
487,1038,11,32,42,37,5
488,1039,19,20,21,21,1
489,1040,5,8,22,16,8
490,1042,12,11,14,12,1
491,1044,11,30,73,59,29
492,1046,16,26,51,45,19
493,1047,18,34,35,35,1
494,1049,15,13,26,21,8
495,1051,19,21,22,22,1
496,1053,16,33,44,42,9
497,1056,13,43,45,45,2
498,1058,17,25,30,28,3
499,1059,12,27,36,36,9
500,1065,9,49,61,57,8
501,1067,16,4,20,15,11
502,1070,23,21,24,23,2
503,1073,11,43,46,45,2
504,1075,4,46,57,55,9
505,1079,9,41,46,45,4
506,1081,17,20,30,26,6
507,1082,11,21,22,21,0
508,1086,13,42,47,47,5
509,1087,16,25,33,30,5
510,1089,11,43,53,52,9
511,1090,16,38,44,43,5
512,1091,20,22,24,23,1
513,1096,7,51,59,57,6
514,1097,12,29,37,36,7
515,1102,10,40,60,54,14
516,1108,20,14,26,19,5
517,1109,6,36,74,41,5
518,1110,18,31,33,33,2
519,1111,18,27,32,31,4
520,1120,13,25,31,30,5
521,1121,25,25,25,25,0
522,1122,21,21,25,25,4
523,1124,12,31,48,38,7
524,1129,11,35,40,40,5
525,1133,17,35,39,37,2
526,1135,14,43,48,47,4
527,1140,24,22,33,26,4
528,1142,5,17,18,18,1
529,1146,10,29,35,30,1
530,1151,18,29,34,33,4
531,1152,17,28,35,35,7
532,1153,12,33,35,34,1
533,1154,12,41,44,42,1
534,1157,11,41,48,47,6
535,1161,57,17,175,19,2
536,1162,20,27,28,27,0
537,1165,11,41,43,43,2
538,1169,19,22,37,33,11
539,1173,18,32,36,34,2
540,1174,5,1,7,7,6
541,1177,11,47,49,48,1
542,1178,19,19,23,22,3
543,1179,15,26,30,29,3
544,1182,16,20,22,22,2
545,1183,6,42,52,50,8
546,1184,18,30,33,32,2
547,1188,14,19,20,19,0
548,1189,15,32,35,35,3
549,1192,22,33,34,34,1
550,1194,20,29,29,29,0
551,1195,15,23,29,27,4
552,1196,14,19,37,28,9
553,1198,17,30,34,31,1
554,1201,12,34,53,42,8
555,1204,18,33,37,37,4
556,1205,20,34,42,40,6
557,1206,15,14,14,14,0
558,1208,15,28,29,29,1
559,1210,4,16,40,40,24
560,1211,9,23,37,31,8
561,1213,5,5,5,5,0
562,1214,21,28,33,32,4
563,1221,12,42,45,43,1
564,1222,8,30,38,38,8
565,1224,17,18,24,22,4
566,1226,11,34,47,43,9
567,1230,11,17,19,19,2
568,1233,17,32,46,41,9
569,1238,12,33,38,35,2
570,1241,23,33,44,34,1
571,1244,20,30,31,31,1
572,1247,12,33,39,37,4
573,1248,12,11,23,12,1
574,1249,15,8,15,15,7
575,1251,4,47,52,52,5
576,1256,15,37,40,40,3
577,1258,13,40,48,45,5
578,1259,16,30,33,33,3
579,1261,14,25,26,25,0
580,1262,8,6,7,7,1
581,1265,6,3,8,4,1
582,1268,25,20,37,36,16
583,1272,21,24,28,27,3
584,1273,16,26,36,32,6
585,1278,18,22,26,25,3
586,1279,6,1,6,4,3
587,1281,7,45,52,50,5
588,1283,13,32,63,41,9
589,1284,15,20,21,21,1
590,1288,22,32,46,39,7
591,1289,13,28,31,30,2
592,1291,12,24,41,38,14
593,1292,24,26,30,29,3
594,1293,10,36,44,41,5
595,1295,17,30,36,35,5
596,1297,16,19,36,23,4
597,1298,10,51,61,59,8
598,1299,9,37,46,45,8
599,1303,7,37,49,45,8
600,1304,8,40,68,50,10
601,1306,10,43,46,46,3
602,1307,13,25,33,26,1
603,1308,15,37,43,42,5
604,1310,16,34,37,35,1
605,1315,8,39,52,52,13
606,1318,11,32,34,34,2
607,1320,6,2,7,7,5
608,1322,7,22,31,27,5
609,1323,16,13,51,19,6
610,1324,9,41,48,47,6
611,1325,18,29,34,32,3
612,1326,16,32,35,35,3
613,1327,16,27,28,28,1
614,1331,8,40,45,42,2
615,1333,13,23,30,27,4
616,1336,9,34,57,48,14
617,1337,11,38,43,43,5
618,1341,9,3,15,10,7
619,1342,5,45,52,50,5
620,1346,10,20,41,32,12
621,1348,17,16,17,17,1
622,1351,15,19,19,19,0
623,1352,6,44,47,47,3
624,1353,4,1,3,3,2
625,1356,13,33,34,34,1
626,1358,16,18,18,18,0
627,1360,15,39,44,41,2
628,1361,16,22,22,22,0
629,1363,11,22,72,25,3
630,1365,11,45,52,51,6
631,1369,15,13,15,14,1
632,1370,12,38,38,38,0
633,1374,18,31,33,33,2
634,1375,14,38,38,38,0
635,1376,9,48,65,63,15
636,1378,6,37,57,52,15
637,1379,18,17,38,27,10
638,1381,21,23,34,29,6
639,1383,12,39,46,46,7
640,1384,10,48,65,54,6
641,1390,15,22,28,28,6
642,1399,10,46,54,52,6
643,1401,9,15,22,16,1
644,1402,13,37,43,41,4
645,1403,14,16,20,17,1
646,1408,17,36,40,40,4
647,1412,15,34,39,34,0
648,1418,14,16,20,18,2
649,1420,14,39,45,42,3
650,1421,17,25,41,36,11
651,1423,13,40,42,42,2
652,1426,16,32,40,36,4
653,1428,19,30,33,33,3
654,1429,17,2,17,16,14
655,1431,17,21,21,21,0
656,1433,18,20,28,23,3
657,1437,19,32,34,33,1
658,1438,17,24,33,32,8
659,1439,4,51,58,58,7
660,1446,5,19,22,22,3
661,1448,15,39,42,40,1
662,1453,9,30,69,35,5
663,1454,3,37,65,63,26
664,1455,13,29,43,34,5
665,1456,24,25,52,37,12
666,1462,11,25,39,32,7
667,1466,13,19,21,21,2
668,1467,5,26,27,27,1
669,1473,19,22,22,22,0
670,1475,8,46,48,47,1
671,1478,17,24,26,26,2
672,1482,17,15,27,22,7
673,1488,1,56,69,66,10
674,1490,10,31,37,36,5
675,1491,11,33,37,37,4
676,1496,11,37,54,47,10
677,1498,16,27,38,32,5
678,1502,14,30,30,30,0
679,1505,22,24,25,25,1
680,1507,9,10,11,11,1
681,1509,17,26,38,31,5
682,1510,19,14,18,17,3
683,1511,19,22,37,29,7
684,1517,7,44,67,58,14
685,1518,13,15,24,18,3
686,1520,15,24,28,26,2
687,1523,12,34,38,37,3
688,1525,17,23,24,24,1
689,1527,8,21,40,23,2
690,1530,10,43,55,54,11
691,1531,15,32,33,33,1
692,1535,16,16,22,18,2
693,1539,8,14,24,18,4
694,1540,12,33,42,42,9
695,1542,23,26,32,30,4
696,1548,17,20,21,21,1
697,1551,12,10,11,11,1
698,1554,9,36,46,45,9
699,1556,12,43,46,45,2
700,1557,10,34,57,41,7
701,1564,20,33,43,43,10
702,1565,9,46,51,50,4
703,1566,9,34,49,43,9
704,1568,18,30,32,30,0
705,1569,26,29,34,33,4
706,1571,11,18,21,20,2
707,1572,20,17,19,19,2
708,1573,11,23,60,27,4
709,1574,17,28,34,33,5
710,1575,14,16,19,19,3
711,1578,9,10,15,11,1
712,1579,19,26,29,29,3
713,1581,12,14,23,15,1
714,1587,20,21,21,21,0
715,1588,13,13,14,14,1
716,1590,9,35,45,44,9
717,1591,20,29,33,33,4
718,1592,12,27,36,31,4
719,1593,9,24,26,25,1
720,1599,19,20,22,22,2
721,1604,17,21,28,24,3
722,1605,9,27,27,27,0
723,1610,19,34,38,37,3
724,1614,23,22,30,29,7
725,1615,8,42,61,55,13
726,1619,10,42,49,46,4
727,1620,15,33,36,36,3
728,1624,17,39,41,40,1
729,1626,5,5,8,5,0
730,1628,10,43,48,47,4
731,1630,11,9,11,10,1
732,1632,8,49,62,60,11
733,1635,4,46,56,53,7
734,1636,16,19,25,22,3
735,1638,12,34,45,45,11
736,1639,19,24,25,25,1
737,1641,17,16,18,18,2
738,1642,15,26,47,39,13
739,1646,13,19,20,20,1
740,1648,11,24,26,24,0
741,1651,20,24,31,29,5
742,1657,14,20,22,20,0
743,1658,4,43,61,58,15
744,1659,21,20,26,25,5
745,1661,5,50,67,66,16
746,1662,14,30,32,32,2
747,1663,18,40,40,40,0
748,1664,12,15,17,17,2
749,1670,25,40,52,40,0
750,1672,12,31,37,35,4
751,1681,9,34,66,56,22
752,1682,5,20,32,23,3
753,1683,10,22,46,33,11
754,1684,20,25,28,27,2
755,1685,17,35,37,37,2
756,1686,17,34,36,36,2
757,1687,16,27,31,30,3
758,1688,9,43,46,45,2
759,1690,9,50,60,59,9
760,1693,3,1,2,2,1
761,1694,18,20,21,20,0
762,1698,16,36,39,39,3
763,1702,18,23,23,23,0
764,1703,19,19,25,23,4
765,1706,11,14,16,16,2
766,1708,15,14,21,17,3
767,1709,12,32,43,41,9
768,1710,21,23,24,24,1
769,1711,12,33,51,48,15
770,1715,16,35,42,40,5
771,1716,8,3,35,4,1
772,1717,6,58,61,61,3
773,1720,15,23,27,26,3
774,1722,6,22,74,62,40
775,1723,24,24,26,26,2
776,1725,5,52,53,53,1
777,1726,11,42,57,56,14
778,1729,21,38,38,38,0
779,1730,21,30,35,35,5
780,1731,19,18,24,21,3
781,1732,13,16,25,25,9
782,1733,10,39,44,44,5
783,1735,19,18,20,18,0
784,1738,16,33,43,42,9
785,1740,16,14,23,16,2
786,1741,15,33,34,34,1
787,1742,15,32,35,34,2
788,1743,25,34,36,36,2
789,1747,16,18,27,26,8
790,1750,12,35,38,38,3
791,1752,17,14,18,17,3
792,1753,13,35,54,40,5
793,1756,13,34,42,42,8
794,1757,19,23,44,29,6
795,1759,15,38,38,38,0
796,1760,4,51,61,56,5
797,1762,19,26,29,28,2
798,1763,13,37,41,41,4
799,1767,17,26,30,30,4
800,1769,16,40,47,44,4
801,1771,17,22,25,25,3
802,1772,15,16,25,19,3
803,1774,14,29,35,34,5
804,1777,20,25,31,30,5
805,1778,11,31,34,34,3
806,1780,6,46,50,49,3
807,1782,17,34,40,36,2
808,1787,18,23,29,28,5
809,1788,13,27,31,30,3
810,1791,21,28,29,29,1
811,1793,10,44,48,48,4
812,1794,16,22,25,24,2
813,1795,8,49,55,55,6
814,1798,23,19,32,30,11
815,1799,19,29,31,30,1
816,1801,19,18,19,19,1
817,1805,4,28,30,29,1
818,1807,7,35,49,44,9
819,1808,10,47,50,50,3
820,1811,12,18,30,20,2
821,1812,15,20,29,24,4
822,1814,7,42,55,55,13
823,1815,5,2,5,3,1
824,1816,17,16,16,16,0
825,1818,13,30,32,32,2
826,1819,11,19,21,21,2
827,1821,19,25,40,34,9
828,1826,7,38,54,47,9
829,1827,16,28,29,29,1
830,1832,10,22,52,47,25
831,1834,23,26,26,26,0
832,1837,13,21,25,24,3
833,1838,11,44,51,48,4
834,1840,12,25,31,26,1
835,1842,16,28,44,39,11
836,1843,15,22,23,23,1
837,1844,18,31,33,33,2
838,1845,20,18,20,19,1
839,1849,15,10,22,16,6
840,1851,7,46,60,59,13
841,1859,18,23,31,29,6
842,1861,10,23,25,25,2
843,1863,21,26,27,27,1
844,1867,12,31,35,34,3
845,1870,14,39,44,44,5
846,1871,10,27,31,30,3
847,1872,12,15,22,17,2
848,1873,8,46,47,47,1
849,1874,24,27,31,30,3
850,1876,18,15,17,17,2
851,1878,21,19,24,24,5
852,1879,6,22,24,24,2
853,1880,8,47,75,61,14
854,1887,13,40,44,41,1
855,1890,13,30,40,38,8
856,1892,18,24,29,28,4
857,1896,11,33,51,37,4
858,1897,10,21,22,22,1
859,1899,16,21,46,42,21
860,1908,12,7,12,11,4
861,1910,21,27,30,29,2
862,1915,14,26,34,32,6
863,1917,17,15,25,18,3
864,1920,15,13,20,19,6
865,1921,15,29,32,32,3
866,1922,17,20,28,27,7
867,1928,21,21,26,23,2
868,1930,5,1,6,1,0
869,1938,16,36,49,48,12
870,1941,19,25,26,26,1
871,1943,8,45,49,48,3
872,1946,11,17,20,20,3
873,1947,11,37,41,41,4
874,1949,15,37,47,42,5
875,1953,17,26,28,27,1
876,1956,9,12,23,18,6
877,1960,9,48,51,51,3
878,1961,14,30,41,38,8
879,1962,9,42,57,57,15
880,1966,20,31,41,40,9
881,1967,20,35,39,38,3
882,1969,14,15,19,18,3
883,1971,15,33,35,35,2
884,1972,7,44,69,66,22
885,1973,5,8,34,15,7
886,1975,15,15,17,16,1
887,1976,19,20,21,21,1
888,1984,15,36,42,41,5
889,1986,16,28,31,31,3
890,1987,2,29,60,46,17
891,1988,17,18,20,20,2
892,1993,13,17,18,17,0
893,1995,11,27,29,28,1
894,1997,11,45,47,47,2
895,1998,19,23,25,25,2
896,1999,14,37,39,39,2
897,2003,19,15,19,18,3
898,2004,15,34,37,36,2
899,2005,13,42,57,57,15
900,2011,12,25,27,26,1
901,2012,18,17,26,20,3
902,2018,22,22,24,23,1
903,2019,19,24,25,24,0
904,2021,5,1,6,1,0
905,2022,6,44,55,53,9
906,2024,17,15,24,19,4
907,2027,22,32,35,35,3
908,2032,17,21,33,26,5
909,2034,8,57,58,58,1
910,2036,17,29,36,34,5
911,2041,14,36,38,38,2
912,2042,19,19,36,32,13
913,2043,10,33,41,39,6
914,2045,13,34,83,48,14
915,2047,11,30,42,35,5
916,2048,15,16,21,18,2
917,2050,9,23,34,32,9
918,2053,20,26,27,26,0
919,2065,18,22,26,23,1
920,2067,15,30,55,35,5
921,2069,19,19,22,20,1
922,2070,14,17,17,17,0
923,2071,11,27,68,60,33
924,2072,14,37,45,44,7
925,2077,6,13,19,15,2
926,2078,6,42,52,47,5
927,2080,18,28,29,29,1
928,2084,15,26,28,27,1
929,2087,13,12,15,14,2
930,2098,6,51,58,58,7
931,2100,19,31,36,35,4
932,2103,10,9,9,9,0
933,2104,18,27,36,35,8
934,2109,15,6,26,18,12
935,2113,14,22,29,26,4
936,2123,5,24,24,24,0
937,2126,14,38,40,40,2
938,2127,9,18,18,18,0
939,2130,23,24,28,27,3
940,2133,17,27,40,35,8
941,2135,14,13,32,16,3
942,2138,15,13,22,14,1
943,2140,15,30,34,33,3
944,2145,1,63,69,69,6
945,2146,16,38,43,40,2
946,2147,9,9,10,10,1
947,2148,10,6,9,8,2
948,2149,7,50,59,58,8
949,2156,20,32,37,35,3
950,2157,18,36,46,44,8
951,2165,12,31,35,34,3
952,2166,17,27,30,29,2
953,2168,15,44,48,48,4
954,2174,20,30,35,33,3
955,2176,12,41,41,41,0
956,2179,16,14,21,16,2
957,2180,15,21,30,26,5
958,2184,11,10,29,21,11
959,2186,2,63,73,72,9
960,2187,4,9,11,11,2
961,2190,9,32,45,36,4
962,2192,13,11,12,11,0
963,2195,17,24,29,28,4
964,2199,10,33,38,36,3
965,2200,16,16,21,19,3
966,2208,13,34,41,39,5
967,2209,7,41,83,64,23
968,2212,3,44,55,55,11
969,2217,18,23,29,25,2
970,2222,12,32,54,49,17
971,2224,14,42,48,47,5
972,2226,4,50,60,59,9
973,2230,15,19,28,25,6
974,2236,15,21,66,48,27
975,2241,11,9,10,10,1
976,2244,16,31,42,36,5
977,2246,24,25,34,31,6
978,2247,20,29,32,30,1
979,2249,7,4,16,8,4
980,2250,17,29,31,31,2
981,2255,17,20,21,20,0
982,2262,12,40,41,41,1
983,2264,13,6,14,12,6
984,2265,15,28,35,35,7
985,2266,13,34,47,43,9
986,2271,6,3,7,4,1
987,2272,23,19,40,36,17
988,2273,23,18,23,22,4
989,2277,16,35,47,40,5
990,2279,10,23,67,64,41
991,2287,4,31,67,46,15
992,2288,19,30,34,34,4
993,2289,16,17,18,18,1
994,2290,15,26,32,29,3
995,2291,10,4,16,11,7
996,2295,13,37,38,38,1
997,2298,18,20,27,24,4
998,2299,12,10,11,11,1
999,2300,22,30,34,32,2
1000,2301,20,22,25,25,3
1001,2302,21,30,31,30,0
1002,2303,23,22,32,27,5
1003,2304,13,41,44,43,2
1004,2305,13,33,35,34,1
1005,2306,7,55,58,56,1
1006,2307,12,35,39,39,4
1007,2311,11,12,44,23,11
1008,2313,15,32,35,34,2
1009,2314,17,32,41,37,5
1010,2318,18,19,25,24,5
1011,2327,7,30,47,33,3
1012,2328,20,19,23,21,2
1013,2333,22,20,23,23,3
1014,2336,11,32,45,45,13
1015,2339,11,12,13,13,1
1016,2342,15,29,35,33,4
1017,2343,18,33,38,37,4
1018,2347,10,33,35,34,1
1019,2349,15,39,44,42,3
1020,2351,15,38,38,38,0
1021,2362,24,35,36,35,0
1022,2368,12,29,39,35,6
1023,2373,15,29,33,33,4
1024,2374,2,64,80,73,9
1025,2375,12,41,42,42,1
1026,2377,20,32,36,36,4
1027,2381,11,38,38,38,0
1028,2385,2,70,87,86,16
1029,2386,13,24,30,28,4
1030,2389,8,47,54,49,2
1031,2392,21,20,22,22,2
1032,2396,18,25,29,27,2
1033,2398,10,41,44,42,1
1034,2400,18,30,52,36,6
1035,2401,12,42,48,46,4
1036,2404,16,18,23,21,3
1037,2405,10,47,51,50,3
1038,2406,10,46,56,49,3
1039,2409,20,26,26,26,0
1040,2410,21,20,25,23,3
1041,2412,17,37,41,40,3
1042,2417,7,50,54,54,4
1043,2419,18,23,35,30,7
1044,2420,6,44,51,50,6
1045,2421,14,35,39,39,4
1046,2422,5,15,22,21,6
1047,2425,12,39,43,43,4
1048,2426,14,21,25,24,3
1049,2427,23,29,31,31,2
1050,2428,9,32,38,38,6
1051,2437,18,33,34,34,1
1052,2438,19,32,33,33,1
1053,2439,12,37,38,38,1
1054,2440,9,41,47,45,4
1055,2445,15,38,55,54,16
1056,2446,10,39,43,40,1
1057,2452,12,39,48,43,4
1058,2454,10,27,33,31,4
1059,2455,17,27,29,28,1
1060,2456,7,62,68,66,4
1061,2457,12,31,38,38,7
1062,2458,10,51,52,52,1
1063,2459,3,51,63,63,12
1064,2460,17,32,39,39,7
1065,2465,12,16,17,16,0
1066,2466,4,40,47,46,6
1067,2473,11,27,47,43,16
1068,2474,7,43,48,47,4
1069,2475,14,35,40,39,4
1070,2477,12,27,30,30,3
1071,2481,21,26,28,28,2
1072,2483,7,42,45,45,3
1073,2484,11,36,38,38,2
1074,2493,15,21,46,31,10
1075,2495,21,33,39,35,2
1076,2499,9,39,49,48,9
1077,2500,17,29,35,33,4
1078,2501,12,46,48,48,2
1079,2503,9,48,54,54,6
1080,2504,13,41,45,44,3
1081,2505,4,40,53,48,8
1082,2506,11,37,70,53,16
1083,2507,19,19,25,23,4
1084,2509,19,38,43,42,4
1085,2510,25,33,35,35,2
1086,2512,10,34,43,39,5
1087,2514,20,28,32,30,2
1088,2515,8,45,59,51,6
1089,2517,2,2,2,2,0
1090,2520,17,27,27,27,0
1091,2522,17,36,44,42,6
1092,2524,14,35,39,38,3
1093,2526,12,37,44,40,3
1094,2527,10,47,59,58,11
1095,2530,16,33,40,39,6
1096,2532,9,35,40,40,5
1097,2533,13,31,32,32,1
1098,2539,12,37,49,42,5
1099,2544,20,34,35,35,1
1100,2546,14,30,34,30,0
1101,2550,9,48,54,53,5
1102,2553,20,30,54,34,4
1103,2555,8,46,53,50,4
1104,2557,17,26,29,29,3
1105,2563,14,38,38,38,0
1106,2564,17,32,32,32,0
1107,2565,10,41,49,49,8
1108,2566,18,35,42,42,7
1109,2570,18,19,19,19,0
1110,2571,11,30,41,41,11
1111,2572,12,23,27,25,2
1112,2573,24,28,29,29,1
1113,2578,14,39,46,44,5
1114,2579,16,13,22,21,8
1115,2582,11,41,48,48,7
1116,2585,4,53,59,56,3
1117,2586,10,39,44,43,4
1118,2587,14,41,42,42,1
1119,2590,14,34,41,41,7
1120,2592,7,49,55,54,5
1121,2593,7,46,58,56,10
1122,2597,9,9,11,10,1
1123,2600,9,43,52,46,3
1124,2602,18,26,32,30,4
1125,2604,18,29,38,36,7
1126,2605,18,34,40,40,6
1127,2606,16,19,20,20,1
1128,2607,10,50,58,53,3
1129,2608,10,43,48,48,5
1130,2612,5,46,52,52,6
1131,2613,16,25,32,30,5
1132,2614,5,52,63,60,8
1133,2615,7,53,61,58,5
1134,2618,13,29,44,32,3
1135,2619,8,39,53,46,7
1136,2620,15,42,45,44,2
1137,2624,15,31,32,31,0
1138,2625,1,51,55,55,4
1139,2627,14,32,44,35,3
1140,2629,12,40,46,45,5
1141,2631,20,22,34,31,9
1142,2635,8,49,50,50,1
1143,2636,12,36,45,41,5
1144,2639,8,16,137,60,44
1145,2641,9,43,49,47,4
1146,2643,15,27,35,34,7
1147,2647,11,44,52,51,7
1148,2649,14,24,30,28,4
1149,2650,9,45,48,45,0
1150,2652,12,34,35,35,1
1151,2653,13,41,49,47,6
1152,2655,15,23,34,27,4
1153,2656,6,42,51,50,8
1154,2657,10,26,30,30,4
1155,2659,2,43,47,47,4
1156,2665,12,36,36,36,0
1157,2666,17,33,34,34,1
1158,2667,17,22,27,25,3
1159,2668,12,42,47,47,5
1160,2669,8,46,51,51,5
1161,2672,7,44,56,56,12
1162,2674,13,35,42,41,6
1163,2675,17,31,33,33,2
1164,2678,17,38,40,40,2
1165,2679,6,40,42,42,2
1166,2680,36,37,62,40,3
1167,2681,7,36,47,46,10
1168,2683,4,50,58,58,8
1169,2686,11,40,47,47,7
1170,2687,10,36,56,49,13
1171,2691,8,41,48,46,5
1172,2694,17,31,33,33,2
1173,2695,10,33,37,37,4
1174,2696,14,44,47,47,3
1175,2699,12,36,40,39,3
1176,2700,11,28,40,31,3
1177,2701,9,47,50,50,3
1178,2706,23,33,34,34,1
1179,2708,14,34,38,37,3
1180,2709,21,28,41,40,12
1181,2712,15,35,38,38,3
1182,2713,8,42,50,47,5
1183,2717,5,8,16,15,7
1184,2719,21,24,24,24,0
1185,2722,15,34,45,37,3
1186,2723,5,60,63,63,3
1187,2724,12,52,58,57,5
1188,2728,19,22,25,25,3
1189,2729,13,31,36,35,4
1190,2736,5,45,61,57,12
1191,2738,14,21,24,22,1
1192,2740,29,24,65,29,5
1193,2741,8,49,53,51,2
1194,2749,20,22,22,22,0
1195,2750,12,48,53,52,4
1196,2752,11,32,68,65,33
1197,2755,7,52,59,58,6
1198,2761,8,9,20,11,2
1199,2762,19,28,31,31,3
1200,2763,18,21,22,22,1
1201,2764,16,43,46,46,3
1202,2765,13,30,37,34,4
1203,2766,5,48,57,55,7
1204,2768,4,54,60,59,5
1205,2770,17,37,41,41,4
1206,2771,22,30,34,32,2
1207,2775,5,45,93,86,41
1208,2777,16,43,43,43,0
1209,2780,18,21,24,23,2
1210,2782,19,32,35,33,1
1211,2788,21,21,22,22,1
1212,2789,12,41,53,53,12
1213,2790,9,45,53,51,6
1214,2792,16,35,37,37,2
1215,2793,9,43,57,57,14
1216,2795,18,23,37,24,1
1217,2796,11,39,40,40,1
1218,2798,7,52,63,60,8
1219,2799,2,53,56,56,3
1220,2804,19,35,42,41,6
1221,2805,9,40,56,54,14
1222,2811,13,25,32,30,5
1223,2813,6,49,51,50,1
1224,2817,1,51,64,63,12
1225,2819,4,57,64,63,6
1226,2820,7,48,53,52,4
1227,2821,15,33,42,37,4
1228,2822,13,29,33,33,4
1229,2823,12,42,49,49,7
1230,2824,16,30,37,37,7
1231,2825,3,52,58,56,4
1232,2827,8,50,52,52,2
1233,2830,12,15,34,20,5
1234,2841,23,25,30,29,4
1235,2845,12,6,12,12,6
1236,2848,14,31,50,41,10
1237,2854,6,37,44,42,5
1238,2855,15,30,36,34,4
1239,2858,2,18,18,18,0
1240,2862,9,47,58,58,11
1241,2863,20,38,42,41,3
1242,2864,13,19,22,22,3
1243,2867,19,12,24,22,10
1244,2870,23,25,30,29,4
1245,2871,13,46,47,47,1
1246,2872,18,28,33,30,2
1247,2877,21,29,34,34,5
1248,2879,7,58,67,65,7
1249,2880,9,39,47,46,7
1250,2881,8,42,51,51,9
1251,2883,6,62,72,72,10
1252,2887,10,48,53,52,4
1253,2890,17,30,37,36,6
1254,2891,15,33,43,37,4
1255,2892,18,34,38,37,3
1256,2893,7,39,48,45,6
1257,2895,19,23,26,25,2
1258,2896,17,35,40,38,3
1259,2897,15,25,28,28,3
1260,2898,12,35,49,38,3
1261,2899,16,36,41,40,4
1262,2900,8,37,55,51,14
1263,2901,10,37,41,37,0
1264,2904,7,50,56,56,6
1265,2907,27,33,36,36,3
1266,2908,31,30,31,31,1
1267,2909,14,28,33,31,3
1268,2913,10,36,47,39,3
1269,2914,14,41,45,45,4
1270,2917,11,32,40,40,8
1271,2923,19,22,25,24,2
1272,2924,12,23,36,29,6
1273,2926,15,25,54,39,14
1274,2928,7,39,47,45,6
1275,2929,21,21,22,22,1
1276,2930,12,40,47,45,5
1277,2931,17,42,44,44,2
1278,2932,16,18,20,20,2
1279,2933,18,29,32,31,2
1280,2934,3,61,69,65,4
1281,2936,16,30,39,38,8
1282,2944,16,37,45,43,6
1283,2945,9,40,42,41,1
1284,2950,12,37,45,38,1
1285,2953,5,3,4,4,1
1286,2955,8,55,65,61,6
1287,2956,14,24,39,32,8
1288,2960,3,54,65,64,10
1289,2965,8,50,54,53,3
1290,2967,18,25,29,26,1
1291,2968,17,37,40,40,3
1292,2970,13,12,21,16,4
1293,2971,10,37,41,40,3
1294,2977,7,53,57,56,3
1295,2979,6,44,65,56,12
1296,2980,18,35,40,39,4
1297,2981,19,25,30,29,4
1298,2982,9,59,75,73,14
1299,2986,8,46,51,51,5
1300,2987,22,29,30,30,1
1301,2988,12,41,51,47,6
1302,2989,13,23,27,24,1
1303,2990,18,17,18,17,0
1304,2992,15,43,49,49,6
1305,2994,19,17,22,20,3
1306,2997,6,48,60,60,12
1307,2998,5,50,56,56,6
1308,2999,13,37,42,41,4
1309,3000,21,29,36,35,6
1310,3001,7,49,50,50,1
1311,3003,13,36,49,44,8
1312,3007,15,36,43,41,5
1313,3008,25,31,31,31,0
1314,3009,15,30,35,34,4
1315,3011,13,41,44,44,3
1316,3013,16,24,28,27,3
1317,3017,11,47,51,51,4
1318,3022,12,26,32,32,6
1319,3023,10,44,46,46,2
1320,3025,14,22,23,23,1
1321,3026,7,50,62,60,10
1322,3028,3,60,66,66,6
1323,3029,12,28,39,31,3
1324,3030,11,23,25,24,1
1325,3031,2,53,59,59,6
1326,3032,12,38,40,38,0
1327,3035,13,38,44,43,5
1328,3036,19,19,23,23,4
1329,3037,12,26,28,26,0
1330,3038,15,20,26,21,1
1331,3040,3,56,68,67,11
1332,3041,3,2,4,2,0
1333,3043,9,14,15,15,1
1334,3044,4,53,70,66,13
1335,3047,11,34,42,41,7
1336,3052,8,48,61,58,10
1337,3053,16,37,37,37,0
1338,3055,6,47,60,59,12
1339,3057,15,37,38,38,1
1340,3062,7,47,53,51,4
1341,3063,8,45,47,47,2
1342,3064,23,28,31,31,3
1343,3065,12,41,45,43,2
1344,3069,13,35,39,39,4
1345,3071,17,31,37,37,6
1346,3072,10,8,10,9,1
1347,3073,24,32,35,33,1
1348,3074,13,30,36,34,4
1349,3077,11,36,42,40,4
1350,3078,14,39,52,52,13
1351,3080,26,27,29,29,2
1352,3084,14,29,37,36,7
1353,3085,23,26,28,27,1
1354,3089,5,56,62,62,6
1355,3100,10,9,9,9,0
1356,3101,11,28,38,33,5
1357,3103,19,21,26,23,2
1358,3106,4,22,23,23,1
1359,3110,11,48,57,56,8
1360,3111,17,33,36,36,3
1361,3114,22,28,34,33,5
1362,3115,19,24,34,26,2
1363,3116,23,24,27,27,3
1364,3118,10,24,34,31,7
1365,3119,15,27,30,29,2
1366,3122,12,45,47,47,2
1367,3123,3,55,64,58,3
1368,3124,12,33,55,51,18
1369,3128,11,17,18,17,0
1370,3132,13,40,45,45,5
1371,3142,18,39,46,44,5
1372,3145,10,20,22,22,2
1373,3147,15,32,39,37,5
1374,3150,11,31,37,34,3
1375,3151,8,43,51,51,8
1376,3152,12,37,45,45,8
1377,3153,21,22,29,25,3
1378,3161,13,22,23,23,1
1379,3162,13,44,51,48,4
1380,3164,8,38,45,43,5
1381,3168,9,37,45,45,8
1382,3172,23,31,33,32,1
1383,3176,11,38,41,41,3
1384,3178,7,49,54,54,5
1385,3180,12,45,53,52,7
1386,3181,14,21,25,25,4
1387,3182,2,61,68,67,6
1388,3187,12,41,45,44,3
1389,3188,14,25,61,60,35
1390,3189,12,50,54,54,4
1391,3190,9,51,56,54,3
1392,3191,10,20,31,25,5
1393,3192,19,23,35,26,3
1394,3194,4,50,57,57,7
1395,3195,17,30,36,36,6
1396,3198,18,21,26,24,3
1397,3199,22,28,28,28,0
1398,3200,5,54,63,60,6
1399,3203,23,27,28,28,1
1400,3204,7,15,21,19,4
1401,3207,6,39,48,45,6
1402,3208,11,28,34,33,5
1403,3209,17,39,45,44,5
1404,3211,15,22,26,26,4
1405,3212,15,31,35,35,4
1406,3214,3,28,32,32,4
1407,3215,21,36,39,37,1
1408,3220,11,24,25,25,1
1409,3221,15,42,46,46,4
1410,3222,18,32,35,35,3
1411,3223,10,39,51,48,9
1412,3225,12,27,39,34,7
1413,3233,8,45,55,55,10
1414,3236,11,46,54,51,5
1415,3238,17,27,38,29,2
1416,3246,17,21,22,22,1
1417,3249,18,25,27,26,1
1418,3250,15,38,42,41,3
1419,3251,7,35,53,49,14
1420,3253,20,33,35,35,2
1421,3254,11,42,44,43,1
1422,3258,7,46,62,61,15
1423,3260,10,46,51,51,5
1424,3262,20,41,44,44,3
1425,3263,18,46,46,46,0
1426,3264,9,37,53,44,7
1427,3268,16,28,34,32,4
1428,3270,5,42,57,52,10
1429,3271,10,13,17,15,2
1430,3275,4,50,55,54,4
1431,3276,13,20,20,20,0
1432,3278,11,34,55,49,15
1433,3279,8,43,49,49,6
1434,3281,12,29,35,34,5
1435,3283,8,15,30,20,5
1436,3284,8,31,50,42,11
1437,3288,6,57,60,59,2
1438,3289,10,45,46,46,1
1439,3291,9,47,54,50,3
1440,3294,6,38,68,56,18
1441,3295,20,35,37,36,1
1442,3298,5,44,58,57,13
1443,3299,5,41,45,45,4
1444,3300,8,44,47,47,3
1445,3301,13,51,53,52,1
1446,3302,7,41,51,47,6
1447,3306,14,29,31,30,1
1448,3309,7,43,47,46,3
1449,3314,23,21,26,25,4
1450,3315,19,22,23,23,1
1451,3318,8,18,23,23,5
1452,3320,19,34,40,40,6
1453,3322,15,41,45,44,3
1454,3323,10,42,44,44,2
1455,3325,9,40,42,42,2
1456,3328,13,32,39,37,5
1457,3329,15,22,34,31,9
1458,3331,3,10,21,19,9
1459,3335,13,43,43,43,0
1460,3336,13,29,42,37,8
1461,3337,6,43,52,52,9
1462,3338,8,46,48,48,2
1463,3340,20,22,24,23,1
1464,3344,16,32,35,35,3
1465,3345,10,46,49,47,1
1466,3348,14,26,32,32,6
1467,3349,15,28,34,33,5
1468,3350,8,40,46,44,4
1469,3352,11,42,55,49,7
1470,3356,7,50,60,59,9
1471,3357,11,24,24,24,0
1472,3358,19,37,43,43,6
1473,3362,12,31,35,34,3
1474,3363,18,22,25,23,1
1475,3365,11,31,37,37,6
1476,3368,16,36,37,37,1
1477,3370,12,25,34,29,4
1478,3371,21,20,20,20,0
1479,3372,17,18,21,21,3
1480,3373,21,32,35,33,1
1481,3374,6,11,57,40,29
1482,3376,19,23,25,24,1
1483,3377,10,57,62,61,4
1484,3379,15,24,30,28,4
1485,3382,15,31,35,35,4
1486,3384,17,14,22,17,3
1487,3387,17,24,26,26,2
1488,3390,20,29,30,30,1
1489,3396,16,22,26,24,2
1490,3397,22,25,29,28,3
1491,3400,13,36,47,46,10
1492,3402,20,35,39,36,1
1493,3404,19,35,47,39,4
1494,3407,13,23,50,42,19
1495,3412,16,27,69,53,26
1496,3415,18,23,32,32,9
1497,3419,5,4,7,4,0
1498,3422,5,50,53,52,2
1499,3425,17,24,26,24,0
1500,3426,16,36,39,39,3
1501,3431,7,39,41,40,1
1502,3432,23,29,30,30,1
1503,3433,17,26,30,28,2
1504,3435,16,17,21,17,0
1505,3436,10,36,51,49,13
1506,3440,10,22,31,27,5
1507,3448,5,27,29,29,2
1508,3455,7,39,46,46,7
1509,3456,11,49,50,50,1
1510,3458,13,29,31,31,2
1511,3462,9,43,54,54,11
1512,3464,17,35,43,42,7
1513,3467,1,1,1,1,0
1514,3468,15,17,39,32,15
1515,3470,10,34,59,56,22
1516,3472,19,37,43,43,6
1517,3483,11,36,37,36,0
1518,3484,14,38,40,40,2
1519,3485,11,38,43,41,3
1520,3487,12,32,39,37,5
1521,3489,13,41,52,49,8
1522,3491,17,31,35,33,2
1523,3497,19,37,44,43,6
1524,3499,7,40,55,46,6
1525,3501,15,31,33,31,0
1526,3503,9,47,57,55,8
1527,3504,18,28,39,39,11
1528,3505,24,36,39,38,2
1529,3506,14,12,13,13,1
1530,3507,18,23,24,23,0
1531,3511,7,50,58,58,8
1532,3512,10,29,37,35,6
1533,3513,17,30,38,37,7
1534,3522,17,38,39,39,1
1535,3530,17,20,22,22,2
1536,3533,5,23,27,25,2
1537,3534,16,36,42,40,4
1538,3535,6,53,58,57,4
1539,3539,11,24,30,28,4
1540,3540,16,39,40,40,1
1541,3542,10,47,58,56,9
1542,3543,8,36,43,42,6
1543,3545,16,36,40,40,4
1544,3546,11,37,39,38,1
1545,3547,9,35,64,46,11
1546,3550,18,27,27,27,0
1547,3551,28,14,36,26,12
1548,3553,16,44,46,46,2
1549,3554,18,29,30,30,1
1550,3557,17,38,42,42,4
1551,3560,13,49,51,51,2
1552,3561,8,49,55,55,6
1553,3565,12,40,46,43,3
1554,3567,6,48,52,51,3
1555,3571,10,21,32,32,11
1556,3572,17,36,39,39,3
1557,3574,2,1,5,1,0
1558,3575,13,42,53,51,9
1559,3576,11,48,59,57,9
1560,3577,15,33,39,38,5
1561,3581,11,45,49,48,3
1562,3582,11,36,38,37,1
1563,3585,12,37,45,44,7
1564,3586,9,41,45,44,3
1565,3587,12,34,40,37,3
1566,3589,14,25,28,28,3
1567,3593,7,55,57,57,2
1568,3597,17,39,43,43,4
1569,3598,20,26,29,28,2
1570,3599,15,30,33,33,3
1571,3601,21,20,25,22,2
1572,3602,9,44,57,53,9
1573,3603,11,38,45,45,7
1574,3604,7,49,54,53,4
1575,3605,11,44,49,49,5
1576,3608,13,7,13,8,1
1577,3613,10,50,53,53,3
1578,3614,16,35,41,41,6
1579,3615,11,37,38,37,0
1580,3616,17,33,37,36,3
1581,3621,16,28,33,33,5
1582,3626,3,48,56,55,7
1583,3628,11,22,24,24,2
1584,3633,11,31,45,43,12
1585,3635,6,49,56,54,5
1586,3637,18,18,20,20,2
1587,3641,18,32,33,33,1
1588,3644,16,38,42,42,4
1589,3647,22,33,69,57,24
1590,3649,23,26,31,30,4
1591,3650,19,35,38,38,3
1592,3651,12,35,37,37,2
1593,3653,15,21,40,26,5
1594,3654,18,33,43,36,3
1595,3656,2,1,7,1,0
1596,3659,18,32,34,32,0
1597,3661,14,30,48,42,12
1598,3663,16,14,16,16,2
1599,3664,15,39,41,41,2
1600,3665,2,60,63,61,1
1601,3668,16,21,31,26,5
1602,3669,21,31,31,31,0
1603,3673,4,28,115,36,8
1604,3674,10,45,49,47,2
1605,3675,12,17,33,25,8
1606,3676,9,44,50,49,5
1607,3677,8,32,67,42,10
1608,3678,16,40,44,44,4
1609,3679,7,5,17,5,0
1610,3684,11,47,50,50,3
1611,3693,10,26,43,37,11
1612,3696,16,24,31,29,5
1613,3697,21,26,43,26,0
1614,3698,4,44,67,62,18
1615,3700,13,37,38,38,1
1616,3701,8,40,44,42,2
1617,3702,11,19,36,20,1
1618,3703,16,37,40,38,1
1619,3704,10,23,24,24,1
1620,3705,14,7,14,13,6
1621,3707,13,37,37,37,0
1622,3708,20,27,29,28,1
1623,3710,9,4,9,8,4
1624,3711,9,45,56,53,8
1625,3713,9,47,50,50,3
1626,3717,13,17,18,17,0
1627,3719,14,32,36,35,3
1628,3723,14,19,36,29,10
1629,3726,4,47,54,54,7
1630,3729,10,24,43,29,5
1631,3730,10,44,46,46,2
1632,3731,15,42,48,46,4
1633,3732,11,38,38,38,0
1634,3734,8,41,51,49,8
1635,3735,10,36,46,45,9
1636,3739,14,40,47,44,4
1637,3741,11,34,36,35,1
1638,3742,9,49,51,51,2
1639,3743,4,62,62,62,0
1640,3744,16,18,60,40,22
1641,3745,12,41,49,47,6
1642,3748,12,25,40,31,6
1643,3755,9,39,53,47,8
1644,3756,4,41,62,54,13
1645,3757,5,53,62,61,8
1646,3758,12,37,38,38,1
1647,3760,4,55,59,59,4
1648,3762,12,39,43,42,3
1649,3763,8,43,53,51,8
1650,3766,5,12,15,14,2
1651,3767,12,23,28,27,4
1652,3768,14,38,41,41,3
1653,3769,7,42,47,46,4
1654,3770,11,48,48,48,0
1655,3771,8,38,52,46,8
1656,3774,16,31,57,45,14
1657,3775,17,38,43,43,5
1658,3776,11,45,52,52,7
1659,3777,21,32,44,44,12
1660,3778,7,49,56,56,7
1661,3781,13,16,20,16,0
1662,3790,20,36,41,40,4
1663,3793,7,53,58,58,5
1664,3794,10,38,44,44,6
1665,3795,10,35,47,45,10
1666,3796,13,35,40,38,3
1667,3797,22,31,35,32,1
1668,3799,10,35,44,44,9
1669,3802,9,17,29,22,5
1670,3803,12,46,48,48,2
1671,3805,9,38,44,41,3
1672,3807,6,40,47,47,7
1673,3809,5,51,55,53,2
1674,3811,23,23,24,24,1
1675,3812,11,18,21,21,3
1676,3813,2,14,15,15,1
1677,3814,21,37,38,38,1
1678,3815,25,25,26,26,1
1679,3817,13,38,55,48,10
1680,3818,19,19,20,19,0
1681,3819,19,36,42,40,4
1682,3820,20,30,34,33,3
1683,3821,8,42,58,54,12
1684,3822,8,30,77,71,41
1685,3824,19,29,29,29,0
1686,3831,9,18,19,19,1
1687,3832,18,23,33,33,10
1688,3836,7,39,46,46,7
1689,3839,13,30,46,36,6
1690,3840,7,53,60,58,5
1691,3841,15,25,26,26,1
1692,3847,23,30,32,30,0
1693,3850,21,19,23,23,4
1694,3851,15,34,37,35,1
1695,3852,13,16,21,17,1
1696,3855,22,29,30,30,1
1697,3857,9,49,57,57,8
1698,3858,17,13,64,22,9
1699,3859,8,54,55,55,1
1700,3860,16,31,43,39,8
1701,3862,17,18,60,37,19
1702,3863,14,44,50,48,4
1703,3865,12,21,23,23,2
1704,3866,13,34,50,48,14
1705,3867,12,38,45,43,5
1706,3870,16,32,35,35,3
1707,3872,12,39,45,44,5
1708,3873,12,41,53,53,12
1709,3875,22,33,36,36,3
1710,3876,22,19,21,20,1
1711,3879,12,38,46,46,8
1712,3882,11,42,44,44,2
1713,3883,8,58,66,66,8
1714,3885,20,19,20,20,1
1715,3886,23,21,25,25,4
1716,3887,10,8,22,13,5
1717,3889,10,36,78,52,16
1718,3892,9,35,41,39,4
1719,3893,5,57,64,64,7
1720,3896,21,23,25,25,2
1721,3897,22,21,25,22,1
1722,3902,11,27,39,35,8
1723,3903,9,43,58,58,15
1724,3904,6,38,42,42,4
1725,3907,18,19,23,21,2
1726,3908,10,46,50,49,3
1727,3909,18,37,45,40,3
1728,3911,20,31,36,34,3
1729,3912,18,19,21,20,1
1730,3915,13,36,42,41,5
1731,3918,10,4,10,8,4
1732,3922,22,20,21,21,1
1733,3926,1,17,25,22,5
1734,3929,21,34,37,36,2
1735,3931,10,11,16,15,4
1736,3932,14,35,40,40,5
1737,3933,6,49,53,52,3
1738,3934,20,21,21,21,0
1739,3935,18,17,20,17,0
1740,3939,12,27,36,36,9
1741,3940,15,34,38,36,2
1742,3943,10,47,51,51,4
1743,3952,26,24,78,41,17
1744,3953,15,25,34,34,9
1745,3954,10,39,45,44,5
1746,3955,16,21,22,22,1
1747,3960,7,43,44,44,1
1748,3961,13,38,46,45,7
1749,3962,18,37,37,37,0
1750,3963,9,39,61,53,14
1751,3966,17,17,18,18,1
1752,3967,5,49,58,53,4
1753,3969,13,36,41,40,4
1754,3971,11,27,39,32,5
1755,3974,21,42,44,44,2
1756,3976,11,33,36,34,1
1757,3979,16,17,19,18,1
1758,3981,17,36,39,39,3
1759,3982,14,33,37,35,2
1760,3984,6,46,59,58,12
1761,3985,15,19,22,22,3
1762,3986,17,33,34,34,1
1763,3987,13,44,49,48,4
1764,3997,13,30,32,31,1
1765,4001,15,35,47,40,5
1766,4005,17,16,18,17,1
1767,4006,14,31,34,31,0
1768,4012,18,33,33,33,0
1769,4014,10,44,50,49,5
1770,4015,13,40,44,42,2
1771,4016,6,53,56,56,3
1772,4017,7,46,49,49,3
1773,4018,11,47,49,49,2
1774,4020,9,48,50,50,2
1775,4021,7,7,9,9,2
1776,4022,22,26,30,28,2
1777,4025,5,47,51,51,4
1778,4027,16,30,36,35,5
1779,4028,19,39,39,39,0
1780,4029,17,35,35,35,0
1781,4030,22,18,24,22,4
1782,4033,6,52,54,54,2
1783,4036,15,37,44,41,4
1784,4039,16,13,20,16,3
1785,4040,7,50,55,55,5
1786,4047,7,38,50,44,6
1787,4054,9,34,40,37,3
1788,4055,12,38,43,42,4
1789,4056,7,49,53,53,4
1790,4060,18,39,42,41,2
1791,4063,16,36,49,46,10
1792,4066,18,18,22,21,3
1793,4068,15,34,37,36,2
1794,4071,11,42,44,43,1
1795,4072,5,44,45,45,1
1796,4076,22,22,26,25,3
1797,4083,18,22,24,24,2
1798,4084,11,39,48,47,8
1799,4088,4,41,46,45,4
1800,4089,14,42,43,43,1
1801,4091,12,34,37,36,2
1802,4092,4,52,57,57,5
1803,4094,16,13,16,15,2
1804,4097,14,31,40,38,7
1805,4098,14,30,44,43,13
1806,4105,14,46,51,49,3
1807,4107,4,47,54,52,5
1808,4108,13,32,52,44,12
1809,4109,17,13,17,17,4
1810,4113,10,43,53,53,10
1811,4118,14,16,32,21,5
1812,4127,18,15,19,19,4
1813,4128,13,33,34,34,1
1814,4130,13,36,41,41,5
1815,4131,2,58,65,62,4
1816,4132,15,16,23,22,6
1817,4137,6,57,58,58,1
1818,4143,25,23,24,24,1
1819,4144,9,22,30,27,5
1820,4148,6,38,48,48,10
1821,4149,9,23,33,28,5
1822,4150,8,6,16,10,4
1823,4151,18,31,34,34,3
1824,4152,14,35,40,39,4
1825,4153,17,31,50,40,9
1826,4157,21,32,36,35,3
1827,4158,15,40,44,42,2
1828,4163,5,57,63,63,6
1829,4164,20,23,28,26,3
1830,4165,17,13,16,16,3
1831,4166,6,52,56,56,4
1832,4168,9,28,84,57,29
1833,4176,8,42,47,45,3
1834,4178,18,19,21,21,2
1835,4179,4,26,30,29,3
1836,4181,12,25,27,25,0
1837,4182,16,28,34,31,3
1838,4183,18,31,36,36,5
1839,4189,11,49,49,49,0
1840,4190,9,37,41,40,3
1841,4191,11,36,49,41,5
1842,4195,14,28,33,31,3
1843,4196,20,22,22,22,0
1844,4198,16,39,43,43,4
1845,4199,14,35,37,37,2
1846,4204,11,35,49,39,4
1847,4205,9,46,49,48,2
1848,4207,15,24,38,34,10
1849,4208,12,15,20,19,4
1850,4209,14,36,37,37,1
1851,4211,15,27,51,37,10
1852,4216,5,11,24,21,10
1853,4217,4,3,26,5,2
1854,4219,18,34,39,39,5
1855,4220,12,42,45,43,1
1856,4221,12,41,45,44,3
1857,4223,17,23,26,26,3
1858,4228,10,43,48,48,5
1859,4230,10,30,46,42,12
1860,4232,9,39,47,42,3
1861,4234,14,31,38,34,3
1862,4238,18,29,33,31,2
1863,4239,11,40,40,40,0
1864,4241,12,37,41,41,4
1865,4242,17,25,25,25,0
1866,4243,14,26,33,32,6
1867,4244,11,43,48,47,4
1868,4251,16,29,49,39,10
1869,4252,15,35,44,44,9
1870,4253,15,39,45,43,4
1871,4256,4,1,4,1,0
1872,4260,2,7,7,7,0
1873,4263,17,31,32,32,1
1874,4265,21,24,26,25,1
1875,4266,8,10,36,10,0
1876,4270,11,34,38,37,3
1877,4275,19,25,52,42,17
1878,4276,17,24,29,28,4
1879,4278,19,25,26,25,0
1880,4282,6,30,34,34,4
1881,4287,20,27,28,28,1
1882,4288,6,19,22,20,1
1883,4289,8,46,46,46,0
1884,4293,12,30,38,33,3
1885,4297,10,44,51,49,5
1886,4299,8,43,54,50,7
1887,4302,20,31,45,37,6
1888,4303,7,48,50,50,2
1889,4307,15,36,40,39,3
1890,4308,19,30,31,31,1
1891,4309,20,36,38,37,1
1892,4313,5,26,31,28,2
1893,4315,6,55,64,63,8
1894,4319,3,46,64,60,14
1895,4320,5,49,52,52,3
1896,4322,9,49,65,64,15
1897,4327,19,23,31,29,6
1898,4328,12,43,53,51,8
1899,4331,9,46,50,49,3
1900,4332,6,57,61,59,2
1901,4333,11,39,40,39,0
1902,4335,17,27,32,32,5
1903,4338,5,48,56,55,7
1904,4343,17,32,42,41,9
1905,4345,8,41,43,43,2
1906,4348,14,27,37,36,9
1907,4350,10,39,43,41,2
1908,4353,23,32,33,33,1
1909,4355,8,42,47,47,5
1910,4359,18,24,30,29,5
1911,4360,6,51,56,56,5
1912,4363,18,41,71,45,4
1913,4364,7,46,54,54,8
1914,4365,17,14,21,17,3
1915,4367,11,43,48,48,5
1916,4371,21,40,43,43,3
1917,4376,2,1,1,1,0
1918,4377,13,45,50,47,2
1919,4378,16,14,29,29,15
1920,4381,21,34,36,36,2
1921,4383,11,46,46,46,0
1922,4385,13,14,33,17,3
1923,4387,25,34,36,36,2
1924,4390,4,35,36,36,1
1925,4393,14,43,45,45,2
1926,4394,13,49,49,49,0
1927,4396,10,30,42,37,7
1928,4402,13,13,15,15,2
1929,4403,16,30,33,32,2
1930,4407,3,50,63,56,6
1931,4410,17,41,44,43,2
1932,4413,18,23,26,25,2
1933,4417,11,25,38,28,3
1934,4418,6,5,9,5,0
1935,4420,19,30,31,30,0
1936,4421,14,43,50,50,7
1937,4423,11,36,38,38,2
1938,4424,15,15,15,15,0
1939,4431,6,51,56,56,5
1940,4434,21,31,35,35,4
1941,4435,24,31,34,34,3
1942,4436,18,22,24,24,2
1943,4437,20,30,32,31,1
1944,4443,10,43,48,48,5
1945,4444,7,40,69,55,15
1946,4451,9,34,49,45,11
1947,4456,11,38,42,42,4
1948,4457,11,39,45,42,3
1949,4460,6,52,56,55,3
1950,4464,11,30,32,32,2
1951,4466,16,18,23,22,4
1952,4472,7,40,47,45,5
1953,4477,9,42,67,62,20
1954,4478,7,50,60,58,8
1955,4481,8,43,45,44,1
1956,4482,11,43,51,50,7
1957,4483,3,52,67,65,13
1958,4484,12,46,47,47,1
1959,4488,17,31,37,37,6
1960,4489,9,44,48,47,3
1961,4490,7,63,84,82,19
1962,4491,10,41,50,49,8
1963,4495,11,39,45,44,5
1964,4496,8,38,42,40,2
1965,4502,19,34,37,36,2
1966,4508,9,44,57,55,11
1967,4509,13,37,44,42,5
1968,4511,16,43,47,46,3
1969,4512,21,23,24,24,1
1970,4513,9,51,52,52,1
1971,4515,15,18,22,21,3
1972,4516,18,40,44,44,4
1973,4518,4,53,63,60,7
1974,4520,20,26,41,40,14
1975,4523,6,42,47,45,3
1976,4525,4,47,64,61,14
1977,4527,19,16,26,21,5
1978,4529,11,36,38,37,1
1979,4536,7,35,39,39,4
1980,4538,15,40,44,43,3
1981,4539,7,43,50,49,6
1982,4541,20,19,22,22,3
1983,4542,14,34,37,36,2
1984,4543,16,41,43,43,2
1985,4546,18,26,28,28,2
1986,4550,12,17,49,37,20
1987,4551,8,6,8,8,2
1988,4553,14,34,39,39,5
1989,4554,18,40,44,44,4
1990,4555,6,52,65,64,12
1991,4557,9,41,53,52,11
1992,4558,11,42,50,46,4
1993,4561,24,23,23,23,0
1994,4563,9,46,58,56,10
1995,4564,13,24,57,35,11
1996,4568,24,28,34,32,4
1997,4573,9,36,44,39,3
1998,4575,4,24,26,24,0
1999,4576,16,29,34,32,3
2000,4577,14,37,44,40,3
2001,4581,8,7,14,8,1
2002,4582,13,35,46,44,9
2003,4583,22,25,29,29,4
2004,4591,17,35,39,39,4
2005,4594,10,45,50,49,4
2006,4596,20,28,33,33,5
2007,4597,10,28,32,31,3
2008,4601,11,20,22,20,0
2009,4602,20,24,27,25,1
2010,4609,10,34,47,47,13
2011,4610,18,26,26,26,0
2012,4611,11,10,18,10,0
2013,4613,19,25,30,29,4
2014,4616,17,17,19,18,1
2015,4620,16,37,37,37,0
2016,4621,18,26,40,36,10
2017,4624,12,14,24,18,4
2018,4626,6,52,57,55,3
2019,4628,15,29,37,33,4
2020,4629,13,44,46,44,0
2021,4632,6,39,58,51,12
2022,4633,20,19,42,29,10
2023,4634,23,27,27,27,0
2024,4635,16,24,27,26,2
2025,4637,18,38,49,49,11
2026,4638,15,25,28,28,3
2027,4639,19,23,28,26,3
2028,4640,9,38,43,39,1
2029,4642,4,13,41,18,5
2030,4646,12,26,32,29,3
2031,4647,6,23,31,26,3
2032,4650,15,22,23,23,1
2033,4652,19,34,40,39,5
2034,4655,14,15,18,17,2
2035,4658,7,47,49,49,2
2036,4661,13,23,25,25,2
2037,4663,12,32,45,45,13
2038,4664,24,22,26,25,3
2039,4666,6,45,53,52,7
2040,4668,5,56,65,65,9
2041,4669,9,47,58,56,9
2042,4675,17,31,37,35,4
2043,4676,8,49,60,58,9
2044,4680,17,35,42,42,7
2045,4681,10,48,51,50,2
2046,4684,17,31,47,39,8
2047,4686,13,41,45,45,4
2048,4688,9,28,31,30,2
2049,4689,11,42,54,50,8
2050,4690,17,25,26,25,0
2051,4692,12,10,23,10,0
2052,4694,12,19,46,30,11
2053,4696,11,26,30,27,1
2054,4700,21,24,28,26,2
2055,4701,11,36,46,44,8
2056,4706,16,20,22,21,1
2057,4707,14,32,35,33,1
2058,4708,17,26,28,27,1
2059,4711,16,20,23,21,1
2060,4718,12,43,46,46,3
2061,4719,17,43,46,46,3
2062,4723,12,41,52,44,3
2063,4727,18,27,29,28,1
2064,4729,2,51,60,59,8
2065,4730,22,22,23,23,1
2066,4732,7,42,51,51,9
2067,4735,9,43,54,51,8
2068,4737,9,39,48,47,8
2069,4740,17,21,23,23,2
2070,4742,2,11,12,12,1
2071,4743,6,40,44,42,2
2072,4745,20,30,33,33,3
2073,4746,17,27,37,34,7
2074,4747,18,33,38,38,5
2075,4749,16,37,37,37,0
2076,4750,15,42,44,44,2
2077,4752,12,29,31,31,2
2078,4757,14,15,21,19,4
2079,4761,14,20,42,29,9
2080,4763,3,2,2,2,0
2081,4766,7,39,45,44,5
2082,4767,21,25,32,32,7
2083,4770,19,26,27,27,1
2084,4773,20,23,28,27,4
2085,4775,15,27,32,32,5
2086,4777,12,20,22,22,2
2087,4779,19,24,31,28,4
2088,4780,18,23,24,24,1
2089,4781,20,23,26,26,3
2090,4782,19,27,32,32,5
2091,4789,8,46,58,57,11
2092,4792,5,57,66,65,8
2093,4793,10,42,44,44,2
2094,4794,5,1,5,1,0
2095,4796,18,33,34,34,1
2096,4797,19,39,39,39,0
2097,4798,7,43,48,48,5
2098,4808,15,43,45,45,2
2099,4809,14,15,18,17,2
2100,4810,11,39,44,44,5
2101,4812,14,41,43,42,1
2102,4814,3,59,60,59,0
2103,4817,13,44,51,51,7
2104,4818,14,13,13,13,0
2105,4819,11,25,30,27,2
2106,4820,10,42,43,43,1
2107,4824,13,29,32,31,2
2108,4826,15,28,30,29,1
2109,4828,7,41,46,45,4
2110,4832,11,30,36,35,5
2111,4837,6,49,58,56,7
2112,4838,7,42,67,48,6
2113,4848,9,32,38,38,6
2114,4849,17,22,22,22,0
2115,4852,10,27,32,30,3
2116,4854,21,25,25,25,0
2117,4857,12,42,49,49,7
2118,4859,19,41,46,44,3
2119,4860,3,1,2,1,0
2120,4863,17,31,45,35,4
2121,4866,12,25,27,27,2
2122,4867,7,56,60,59,3
2123,4872,13,37,42,42,5
2124,4875,14,22,53,25,3
2125,4876,18,20,23,23,3
2126,4879,12,40,43,43,3
2127,4880,11,37,46,45,8
2128,4881,15,32,40,38,6
2129,4886,16,25,34,33,8
2130,4887,11,17,17,17,0
2131,4890,18,30,32,32,2
2132,4891,17,25,41,35,10
2133,4892,20,20,22,22,2
2134,4893,14,43,46,46,3
2135,4897,14,36,39,38,2
2136,4898,18,20,26,25,5
2137,4900,16,32,36,35,3
2138,4901,16,25,28,27,2
2139,4902,19,31,35,31,0
2140,4904,13,15,20,20,5
2141,4905,8,48,57,54,6
2142,4911,5,51,55,54,3
2143,4912,10,38,44,44,6
2144,4918,2,55,68,65,10
2145,4919,5,9,9,9,0
2146,4920,18,21,24,23,2
2147,4924,8,44,54,53,9
2148,4927,18,26,27,27,1
2149,4932,19,21,23,22,1
2150,4934,2,59,67,67,8
2151,4935,24,26,32,31,5
2152,4937,17,29,36,34,5
2153,4943,18,17,19,18,1
2154,4945,7,54,57,57,3
2155,4946,19,16,19,18,2
2156,4949,22,37,39,38,1
2157,4950,8,50,78,72,22
2158,4951,10,35,39,38,3
2159,4952,11,26,28,28,2
2160,4953,7,46,49,48,2
2161,4954,11,22,34,31,9
2162,4955,14,31,33,33,2
2163,4957,10,41,50,50,9
2164,4958,8,43,50,50,7
2165,4961,12,42,47,46,4
2166,4963,20,26,30,29,3
2167,4965,9,44,46,45,1
2168,4967,12,24,31,30,6
2169,4971,9,47,54,54,7
2170,4974,11,39,46,45,6
2171,4975,7,35,43,41,6
2172,4976,15,31,33,33,2
2173,4977,9,45,50,50,5
2174,4980,17,21,22,22,1
2175,4981,17,35,40,40,5
2176,4986,15,38,41,41,3
2177,4990,19,19,20,20,1
2178,4991,13,30,34,33,3
2179,4996,9,22,31,30,8
2180,5001,23,32,34,34,2
2181,5002,13,9,20,20,11
2182,5004,17,31,31,31,0
2183,5005,8,45,51,50,5
2184,5006,11,31,43,40,9
2185,5009,8,27,32,28,1
2186,5010,9,40,54,51,11
2187,5013,19,33,41,39,6
2188,5014,10,37,52,41,4
2189,5015,19,17,30,24,7
2190,5016,7,38,41,41,3
2191,5017,17,16,26,19,3
2192,5021,22,24,25,25,1
2193,5027,14,31,43,37,6
2194,5029,11,32,47,41,9
2195,5033,17,1,33,15,14
2196,5036,14,37,44,42,5
2197,5040,18,37,40,39,2
2198,5041,21,25,29,28,3
2199,5050,16,23,28,28,5
2200,5057,14,35,35,35,0
2201,5061,8,40,44,42,2
2202,5066,15,28,29,29,1
2203,5069,7,39,41,41,2
2204,5071,11,35,36,36,1
2205,5073,18,31,35,35,4
2206,5075,10,40,46,45,5
2207,5076,10,50,51,51,1
2208,5082,14,37,38,37,0
2209,5084,4,52,54,54,2
2210,5085,21,32,33,33,1
2211,5086,6,50,55,55,5
2212,5088,9,37,49,47,10
2213,5090,15,21,21,21,0
2214,5091,19,33,38,38,5
2215,5092,19,17,18,18,1
2216,5094,16,38,41,41,3
2217,5095,10,47,48,48,1
2218,5096,14,34,44,41,7
2219,5097,23,32,33,33,1
2220,5099,14,41,47,46,5
2221,5100,10,37,39,39,2
2222,5101,4,56,68,67,11
2223,5104,12,44,46,45,1
2224,5110,5,45,51,51,6
2225,5111,14,25,36,32,7
2226,5114,22,27,31,31,4
2227,5115,11,44,48,46,2
2228,5117,11,51,54,54,3
2229,5119,24,40,111,110,70
2230,5121,22,22,23,23,1
2231,5123,2,1,2,1,0
2232,5125,16,34,37,36,2
2233,5129,12,34,36,36,2
2234,5132,15,38,45,44,6
2235,5133,11,37,39,39,2
2236,5134,16,30,34,33,3
2237,5136,13,40,43,43,3
2238,5138,6,46,56,54,8
2239,5147,3,58,67,65,7
2240,5149,11,43,49,48,5
2241,5154,9,46,48,48,2
2242,5161,22,29,33,33,4
2243,5164,13,32,36,36,4
2244,5165,7,52,60,59,7
2245,5166,4,55,61,60,5
2246,5168,12,37,39,39,2
2247,5170,10,28,38,32,4
2248,5174,15,30,34,32,2
2249,5176,7,55,56,56,1
2250,5177,17,19,21,20,1
2251,5178,5,59,61,59,0
2252,5179,12,39,43,42,3
2253,5183,16,24,30,25,1
2254,5188,3,53,63,60,7
2255,5192,16,13,16,15,2
2256,5193,12,44,46,46,2
2257,5194,17,39,39,39,0
2258,5195,9,50,55,55,5
2259,5202,8,35,38,38,3
2260,5203,16,27,37,31,4
2261,5205,21,21,23,23,2
2262,5206,17,30,35,34,4
2263,5210,22,23,26,26,3
2264,5212,17,23,24,24,1
2265,5214,9,28,41,38,10
2266,5215,8,50,53,53,3
2267,5216,12,43,47,45,2
2268,5218,7,32,42,37,5
2269,5220,21,21,21,21,0
2270,5223,13,29,31,30,1
2271,5224,10,37,44,43,6
2272,5229,12,18,24,21,3
2273,5230,6,47,53,52,5
2274,5232,15,23,30,28,5
2275,5233,6,51,60,58,7
2276,5234,15,22,24,24,2
2277,5237,8,25,27,27,2
2278,5238,3,50,57,56,6
2279,5243,7,6,6,6,0
2280,5245,12,28,55,50,22
2281,5246,6,46,54,52,6
2282,5248,11,40,43,43,3
2283,5249,15,24,25,25,1
2284,5251,10,39,44,43,4
2285,5257,16,43,43,43,0
2286,5258,17,41,44,43,2
2287,5259,19,41,47,45,4
2288,5261,20,21,22,22,1
2289,5262,6,38,41,41,3
2290,5267,22,31,31,31,0
2291,5268,11,31,38,36,5
2292,5270,10,35,51,49,14
2293,5271,11,35,41,37,2
2294,5274,20,26,29,29,3
2295,5275,9,49,49,49,0
2296,5276,9,50,56,55,5
2297,5280,8,35,44,43,8
2298,5283,13,26,30,27,1
2299,5287,11,38,49,49,11
2300,5288,9,35,41,40,5
2301,5291,10,8,15,13,5
2302,5292,12,38,38,38,0
2303,5295,12,12,13,13,1
2304,5296,9,38,40,39,1
2305,5297,4,50,69,67,17
2306,5298,7,39,44,41,2
2307,5304,11,9,16,9,0
2308,5305,9,50,53,53,3
2309,5306,2,70,74,74,4
2310,5308,3,50,60,59,9
2311,5310,13,24,29,27,3
2312,5311,14,17,17,17,0
2313,5313,10,48,55,54,6
2314,5314,5,55,63,62,7
2315,5315,4,46,50,50,4
2316,5317,19,24,25,25,1
2317,5320,18,37,43,43,6
2318,5323,8,30,36,33,3
2319,5326,4,51,73,73,22
2320,5327,6,46,51,51,5
2321,5328,12,35,37,37,2
2322,5330,14,38,42,41,3
2323,5333,24,15,23,20,5
2324,5335,4,60,71,63,3
2325,5337,17,25,29,25,0
2326,5340,13,44,45,45,1
2327,5347,14,33,43,43,10
2328,5350,14,28,41,38,10
2329,5351,14,33,36,36,3
2330,5354,14,41,44,42,1
2331,5355,23,35,36,36,1
2332,5359,22,24,26,25,1
2333,5360,17,34,38,36,2
2334,5361,11,46,52,49,3
2335,5365,18,20,20,20,0
2336,5367,11,32,42,41,9
2337,5369,11,49,51,51,2
2338,5370,21,24,24,24,0
2339,5372,14,44,47,47,3
2340,5373,15,32,36,34,2
2341,5375,13,41,46,46,5
2342,5376,15,35,40,40,5
2343,5378,9,29,31,31,2
2344,5380,5,49,58,55,6
2345,5381,12,32,36,34,2
2346,5382,8,43,47,46,3
2347,5384,10,45,47,47,2
2348,5385,9,17,34,27,10
2349,5386,13,28,37,32,4
2350,5387,17,10,21,19,9
2351,5394,17,28,33,31,3
2352,5396,15,28,29,28,0
2353,5402,16,33,33,33,0
2354,5404,9,43,46,46,3
2355,5410,15,29,33,33,4
2356,5411,10,31,33,33,2
2357,5413,12,42,51,51,9
2358,5416,18,25,26,26,1
2359,5417,1,55,64,63,8
2360,5418,16,48,50,50,2
2361,5421,24,20,38,33,13
2362,5422,21,34,39,39,5
2363,5428,5,48,58,57,9
2364,5429,22,31,33,33,2
2365,5431,11,44,47,46,2
2366,5432,21,33,33,33,0
2367,5433,7,19,30,21,2
2368,5434,12,33,36,36,3
2369,5441,8,49,54,52,3
2370,5443,4,49,61,59,10
2371,5446,17,31,34,32,1
2372,5449,12,40,42,41,1
2373,5450,13,41,46,45,4
2374,5453,17,33,34,34,1
2375,5454,8,47,55,54,7
2376,5456,4,14,37,35,21
2377,5458,14,33,41,36,3
2378,5461,17,25,36,34,9
2379,5462,19,37,37,37,0
2380,5465,11,28,38,37,9
2381,5468,12,45,47,46,1
2382,5470,8,37,42,42,5
2383,5471,10,46,47,47,1
2384,5472,12,22,24,24,2
2385,5473,21,30,31,31,1
2386,5477,7,45,54,52,7
2387,5479,19,29,32,31,2
2388,5480,18,21,23,22,1
2389,5482,26,22,28,27,5
2390,5483,19,36,38,38,2
2391,5484,24,31,34,32,1
2392,5487,20,21,31,27,6
2393,5488,19,39,43,43,4
2394,5489,18,35,37,36,1
2395,5491,18,38,42,42,4
2396,5494,10,45,47,47,2
2397,5495,16,26,29,29,3
2398,5496,11,45,46,46,1
2399,5501,13,24,25,25,1
2400,5502,13,40,53,51,11
2401,5504,18,32,37,35,3
2402,5505,9,47,54,52,5
2403,5507,15,37,40,40,3
2404,5514,10,36,36,36,0
2405,5515,9,35,41,41,6
2406,5518,14,41,44,42,1
2407,5519,12,32,33,33,1
2408,5521,16,36,45,43,7
2409,5522,8,39,45,45,6
2410,5530,17,30,31,31,1
2411,5532,6,46,51,50,4
2412,5533,20,22,28,25,3
2413,5535,5,51,61,61,10
2414,5536,11,42,47,46,4
2415,5537,8,32,42,35,3
2416,5538,6,45,53,53,8
2417,5543,6,43,51,48,5
2418,5544,9,46,48,48,2
2419,5545,6,54,58,55,1
2420,5550,17,29,33,31,2
2421,5552,15,38,40,38,0
2422,5554,8,41,49,48,7
2423,5557,13,39,41,41,2
2424,5558,8,44,48,45,1
2425,5559,11,45,51,50,5
2426,5561,6,58,69,66,8
2427,5564,12,39,50,49,10
2428,5568,13,43,46,46,3
2429,5569,10,45,47,47,2
2430,5580,3,1,2,1,0
2431,5581,9,70,74,72,2
2432,5582,13,41,45,43,2
2433,5583,19,35,36,36,1
2434,5586,13,31,31,31,0
2435,5590,11,37,40,39,2
2436,5591,8,37,42,41,4
2437,5596,7,43,45,44,1
2438,5597,7,1,6,6,5
2439,5598,17,38,39,39,1
2440,5604,8,39,48,44,5
2441,5605,11,40,59,56,16
2442,5606,18,18,21,21,3
2443,5613,14,39,47,45,6
2444,5614,9,46,49,49,3
2445,5615,3,52,61,61,9
2446,5616,7,45,51,49,4
2447,5618,21,17,119,22,5
2448,5624,16,44,47,46,2
2449,5630,14,30,42,40,10
2450,5632,3,9,10,9,0
2451,5635,19,32,37,34,2
2452,5637,15,38,41,40,2
2453,5639,9,34,35,35,1
2454,5640,12,39,48,48,9
2455,5641,6,53,67,61,8
2456,5645,14,38,43,41,3
2457,5648,8,45,56,52,7
2458,5650,11,44,49,49,5
2459,5651,11,43,45,45,2
2460,5652,14,35,42,41,6
2461,5655,20,37,43,42,5
2462,5657,9,46,51,51,5
2463,5658,10,23,31,25,2
2464,5659,11,44,49,49,5
2465,5661,13,37,40,40,3
2466,5666,24,25,27,27,2
2467,5668,19,29,31,31,2
2468,5672,12,47,54,52,5
2469,5680,10,43,50,50,7
2470,5682,3,53,58,57,4
2471,5685,11,41,50,50,9
2472,5688,3,64,80,79,15
2473,5689,18,26,28,28,2
2474,5693,15,41,41,41,0
2475,5697,11,40,42,42,2
2476,5698,16,39,44,44,5
2477,5699,12,23,28,24,1
2478,5700,16,30,35,33,3
2479,5706,16,18,23,20,2
2480,5712,7,38,47,47,9
2481,5713,2,58,61,61,3
2482,5714,11,51,52,52,1
2483,5717,12,25,27,26,1
2484,5720,6,46,58,57,11
2485,5721,8,33,34,34,1
2486,5722,4,13,14,13,0
2487,5723,5,46,49,49,3
2488,5724,14,45,51,49,4
2489,5725,15,27,35,32,5
2490,5726,16,29,29,29,0
2491,5732,23,27,29,27,0
2492,5735,13,10,19,13,3
2493,5742,5,44,56,55,11
2494,5744,14,19,27,27,8
2495,5745,18,41,50,49,8
2496,5747,8,42,51,48,6
2497,5748,14,33,41,36,3
2498,5755,10,27,28,28,1
2499,5758,11,47,49,49,2
2500,5759,2,57,67,64,7
2501,5760,10,46,52,52,6
2502,5763,8,47,52,49,2
2503,5766,9,43,54,52,9
2504,5770,11,8,10,10,2
2505,5771,7,51,53,53,2
2506,5773,12,18,21,19,1
2507,5775,11,33,56,49,16
2508,5776,16,34,36,36,2
2509,5777,11,50,51,51,1
2510,5779,20,34,35,35,1
2511,5781,17,28,30,30,2
2512,5787,16,37,43,43,6
2513,5789,18,34,36,36,2
2514,5790,11,10,13,11,1
2515,5799,12,14,17,17,3
2516,5800,21,21,24,23,2
2517,5801,16,28,30,30,2
2518,5808,13,31,38,35,4
2519,5810,17,31,38,38,7
2520,5811,10,41,48,48,7
2521,5814,8,45,59,58,13
2522,5815,9,51,56,54,3
2523,5816,18,39,41,40,1
2524,5819,18,30,32,31,1
2525,5820,22,25,26,26,1
2526,5821,19,26,27,27,1
2527,5825,11,16,52,23,7
2528,5826,8,7,7,7,0
2529,5830,18,32,32,32,0
2530,5833,17,35,39,37,2
2531,5836,2,51,58,57,6
2532,5838,14,36,42,42,6
2533,5839,11,41,50,47,6
2534,5842,12,40,43,43,3
2535,5843,14,33,36,36,3
2536,5846,20,37,40,40,3
2537,5848,17,40,46,46,6
2538,5852,16,18,20,19,1
2539,5854,22,32,37,37,5
2540,5860,17,34,38,38,4
2541,5863,17,37,37,37,0
2542,5864,15,29,46,38,9
2543,5867,12,24,27,24,0
2544,5870,4,54,62,59,5
2545,5871,8,41,49,48,7
2546,5874,4,1,3,2,1
2547,5875,5,45,57,54,9
2548,5876,8,49,52,51,2
2549,5882,13,37,39,39,2
2550,5886,14,38,45,45,7
2551,5891,15,40,40,40,0
2552,5892,13,43,47,45,2
2553,5893,17,26,32,27,1
2554,5894,10,49,55,55,6
2555,5895,9,20,27,20,0
2556,5898,10,22,45,29,7
2557,5901,3,60,68,67,7
2558,5907,13,34,45,42,8
2559,5908,15,37,38,38,1
2560,5909,11,6,14,6,0
2561,5911,12,30,38,36,6
2562,5912,8,28,40,35,7
2563,5913,4,54,60,59,5
2564,5916,11,51,57,57,6
2565,5920,7,28,90,55,27
2566,5922,4,51,60,59,8
2567,5925,18,25,27,26,1
2568,5926,16,41,45,45,4
2569,5927,8,52,56,56,4
2570,5928,20,29,34,33,4
2571,5934,12,25,54,29,4
2572,5936,21,21,23,22,1
2573,5942,3,57,68,67,10
2574,5945,18,32,34,32,0
2575,5948,8,44,49,48,4
2576,5950,22,36,42,41,5
2577,5953,17,31,32,32,1
2578,5954,11,22,23,23,1
2579,5956,17,20,21,21,1
2580,5959,17,21,30,25,4
2581,5960,5,55,60,60,5
2582,5961,13,41,44,42,1
2583,5964,6,45,50,50,5
2584,5965,10,53,63,59,6
2585,5968,23,26,30,26,0
2586,5971,9,54,62,62,8
2587,5973,4,48,60,58,10
2588,5977,4,51,54,52,1
2589,5978,19,22,22,22,0
2590,5979,18,24,26,25,1
2591,5982,20,43,47,47,4
2592,5983,11,40,41,41,1
2593,5984,3,2,2,2,0
2594,5986,7,57,60,58,1
2595,5988,13,32,40,39,7
2596,5989,7,52,57,54,2
2597,5999,16,27,31,29,2
2598,6003,12,37,39,39,2
2599,6004,7,10,13,11,1
2600,6006,13,43,45,45,2
2601,6009,11,41,46,46,5
2602,6010,17,25,32,30,5
2603,6012,2,52,64,62,10
2604,6016,11,45,54,53,8
2605,6017,11,43,46,45,2
2606,6018,11,28,31,30,2
2607,6019,25,29,29,29,0
2608,6021,6,30,36,32,2
2609,6023,9,50,55,54,4
2610,6025,20,27,32,31,4
2611,6026,10,39,43,41,2
2612,6027,10,32,65,55,23
2613,6031,19,28,32,29,1
2614,6034,14,28,36,34,6
2615,6035,4,43,48,48,5
2616,6036,19,32,34,33,1
2617,6037,3,50,60,60,10
2618,6038,7,47,55,53,6
2619,6040,16,41,45,45,4
2620,6046,16,32,35,35,3
2621,6050,10,50,58,57,7
2622,6051,4,45,67,58,13
2623,6052,10,42,47,46,4
2624,6053,4,41,62,58,17
2625,6064,10,33,34,34,1
2626,6067,1,59,69,68,9
2627,6068,9,44,46,45,1
2628,6072,6,13,24,20,7
2629,6076,29,33,33,33,0
2630,6078,7,48,62,57,9
2631,6079,11,38,46,46,8
2632,6082,12,44,46,45,1
2633,6084,18,34,35,35,1
2634,6085,14,39,48,46,7
2635,6086,11,38,40,40,2
2636,6087,11,17,21,19,2
2637,6088,12,18,29,25,7
2638,6089,18,42,45,44,2
2639,6092,13,40,44,44,4
2640,6093,12,36,39,39,3
2641,6098,17,26,29,28,2
2642,6099,13,40,44,43,3
2643,6100,21,33,39,35,2
2644,6107,15,33,38,35,2
2645,6108,12,38,46,46,8
2646,6115,10,42,46,45,3
2647,6116,12,36,40,40,4
2648,6121,19,30,31,31,1
2649,6122,7,44,65,62,18
2650,6123,19,32,36,35,3
2651,6124,9,38,45,45,7
2652,6130,11,50,50,50,0
2653,6132,15,30,36,35,5
2654,6134,6,52,61,60,8
2655,6137,4,52,53,53,1
2656,6140,12,28,30,30,2
2657,6146,15,21,46,30,9
2658,6147,15,16,17,17,1
2659,6148,11,41,51,50,9
2660,6155,18,29,35,35,6
2661,6156,4,55,62,62,7
2662,6157,14,20,21,21,1
2663,6158,6,50,64,62,12
2664,6159,14,34,41,40,6
2665,6163,10,33,52,51,18
2666,6164,20,25,28,27,2
2667,6166,13,45,48,48,3
2668,6168,18,16,17,17,1
2669,6170,14,32,42,41,9
2670,6173,9,33,40,37,4
2671,6174,10,38,44,44,6
2672,6176,18,17,17,17,0
2673,6177,18,18,18,18,0
2674,6179,7,47,67,64,17
2675,6180,22,31,31,31,0
2676,6181,11,45,47,47,2
2677,6182,19,28,28,28,0
2678,6183,23,29,34,34,5
2679,6186,17,37,39,39,2
2680,6187,14,41,45,44,3
2681,6189,13,30,33,32,2
2682,6193,9,37,42,42,5
2683,6196,9,50,67,63,13
2684,6199,3,55,62,61,6
2685,6200,20,29,29,29,0
2686,6203,12,44,51,51,7
2687,6206,7,62,84,82,20
2688,6210,23,34,36,36,2
2689,6211,13,33,36,36,3
2690,6212,16,38,40,40,2
2691,6213,9,41,48,47,6
2692,6214,16,33,37,34,1
2693,6215,12,36,39,39,3
2694,6217,16,30,33,32,2
2695,6221,11,35,41,40,5
2696,6222,6,29,48,42,13
2697,6226,12,41,46,44,3
2698,6227,20,16,20,19,3
2699,6228,19,19,20,20,1
2700,6229,8,30,34,34,4
2701,6230,15,36,37,36,0
2702,6234,15,38,41,41,3
2703,6235,10,28,33,32,4
2704,6236,14,32,35,34,2
2705,6237,8,33,42,41,8
2706,6239,13,20,23,23,3
2707,6242,12,49,52,51,2
2708,6245,6,41,52,45,4
2709,6246,5,44,54,53,9
2710,6253,8,52,56,55,3
2711,6255,15,41,44,43,2
2712,6259,5,25,35,34,9
2713,6264,16,39,46,46,7
2714,6266,11,46,48,48,2
2715,6267,16,38,41,41,3
2716,6268,6,51,56,55,4
2717,6271,19,34,37,37,3
2718,6272,9,44,51,50,6
2719,6273,8,50,51,51,1
2720,6274,19,26,30,29,3
2721,6275,19,40,41,41,1
2722,6276,20,16,19,18,2
2723,6277,12,41,51,50,9
2724,6278,14,43,62,47,4
2725,6282,17,36,44,41,5
2726,6285,21,24,28,27,3
2727,6286,15,47,52,49,2
2728,6287,13,39,44,43,4
2729,6292,17,38,39,39,1
2730,6294,12,11,11,11,0
2731,6295,23,32,34,33,1
2732,6298,11,38,44,44,6
2733,6301,15,37,38,38,1
2734,6304,11,27,31,29,2
2735,6305,19,35,36,36,1
2736,6306,10,42,43,43,1
2737,6309,3,50,52,52,2
2738,6310,12,17,35,25,8
2739,6319,10,43,48,47,4
2740,6320,6,55,60,59,4
2741,6321,23,29,33,33,4
2742,6326,11,41,43,43,2
2743,6327,6,52,56,56,4
2744,6329,12,45,53,53,8
2745,6330,15,33,39,38,5
2746,6331,8,30,31,31,1
2747,6336,14,32,37,36,4
2748,6337,19,25,26,26,1
2749,6338,14,30,35,34,4
2750,6345,16,21,28,23,2
2751,6346,6,38,49,48,10
2752,6347,11,39,47,47,8
2753,6348,4,56,66,66,10
2754,6349,8,57,61,60,3
2755,6350,23,33,38,36,3
2756,6352,12,40,49,47,7
2757,6353,12,34,39,39,5
2758,6354,13,27,33,31,4
2759,6359,23,34,36,36,2
2760,6360,14,39,43,43,4
2761,6364,18,19,29,25,6
2762,6365,4,54,55,55,1
2763,6367,14,39,48,46,7
2764,6368,18,29,32,31,2
2765,6373,21,42,48,45,3
2766,6375,6,52,61,59,7
2767,6382,7,56,60,60,4
2768,6383,7,45,66,61,16
2769,6386,7,51,55,54,3
2770,6388,7,49,51,51,2
2771,6392,18,27,31,30,3
2772,6393,14,32,41,40,8
2773,6396,3,48,54,52,4
2774,6397,19,29,30,30,1
2775,6399,8,48,52,52,4
2776,6413,17,16,16,16,0
2777,6417,16,30,34,33,3
2778,6420,15,41,44,43,2
2779,6422,19,39,42,42,3
2780,6426,9,33,39,38,5
2781,6432,14,24,25,24,0
2782,6438,21,18,23,23,5
2783,6446,8,32,54,50,18
2784,6449,11,24,28,26,2
2785,6450,19,18,19,19,1
2786,6458,14,44,49,48,4
2787,6461,20,23,30,25,2
2788,6464,10,45,46,46,1
2789,6469,9,41,47,47,6
2790,6470,16,21,32,27,6
2791,6472,12,28,33,32,4
2792,6476,7,44,48,47,3
2793,6480,13,33,41,41,8
2794,6481,10,35,37,37,2
2795,6482,8,42,42,42,0
2796,6484,16,18,18,18,0
2797,6485,16,29,33,33,4
2798,6486,7,43,50,49,6
2799,6491,19,31,36,33,2
2800,6492,4,24,50,49,25
2801,6493,13,38,40,38,0
2802,6496,7,46,54,54,8
2803,6498,11,35,38,38,3
2804,6502,9,39,44,44,5
2805,6503,22,30,39,34,4
2806,6505,19,22,23,23,1
2807,6506,12,41,45,43,2
2808,6508,22,22,25,24,2
2809,6520,8,51,51,51,0
2810,6522,11,37,46,45,8
2811,6523,12,40,45,45,5
2812,6524,22,29,36,32,3
2813,6525,21,22,29,25,3
2814,6527,11,42,47,47,5
2815,6529,15,32,32,32,0
2816,6530,6,48,56,55,7
2817,6535,20,25,30,29,4
2818,6546,7,46,53,53,7
2819,6549,20,26,36,34,8
2820,6550,16,14,16,14,0
2821,6554,19,44,51,46,2
2822,6555,13,22,33,33,11
2823,6558,13,49,52,51,2
2824,6559,18,28,30,30,2
2825,6561,9,51,55,52,1
2826,6564,16,31,32,32,1
2827,6566,8,33,45,40,7
2828,6569,13,41,52,51,10
2829,6573,17,19,19,19,0
2830,6576,26,26,26,26,0
2831,6578,13,27,31,30,3
2832,6579,10,47,55,54,7
2833,6580,4,50,68,65,15
2834,6588,9,51,52,51,0
2835,6589,13,35,40,38,3
2836,6593,20,26,32,31,5
2837,6597,15,39,41,41,2
2838,6599,18,37,40,40,3
2839,6602,16,40,42,42,2
2840,6607,17,19,19,19,0
2841,6613,17,19,21,21,2
2842,6614,21,13,21,20,7
2843,6615,14,35,43,42,7
2844,6619,17,37,37,37,0
2845,6620,17,24,29,27,3
2846,6621,7,45,49,48,3
2847,6629,19,31,33,33,2
2848,6630,14,44,48,48,4
2849,6631,16,19,20,20,1
2850,6637,19,38,39,39,1
2851,6640,21,22,26,26,4
2852,6642,6,7,8,8,1
2853,6645,8,41,50,49,8
2854,6650,6,54,57,56,2
2855,6651,10,22,32,25,3
2856,6653,14,22,35,32,10
2857,6659,15,35,35,35,0
2858,6665,7,44,46,46,2
2859,6666,7,56,57,57,1
2860,6667,17,35,37,37,2
2861,6668,14,37,40,39,2
2862,6670,14,24,27,27,3
2863,6671,11,39,45,44,5
2864,6672,15,32,38,37,5
2865,6673,15,31,38,36,5
2866,6674,16,42,43,43,1
2867,6675,17,31,33,33,2
2868,6676,14,45,48,47,2
2869,6677,17,35,39,39,4
2870,6678,8,48,54,54,6
2871,6691,8,47,48,48,1
2872,6694,16,35,36,36,1
2873,6697,21,20,34,25,5
2874,6701,7,43,48,48,5
2875,6704,16,26,31,28,2
2876,6707,13,29,44,39,10
2877,6708,8,47,55,54,7
2878,6711,20,27,33,31,4
2879,6712,7,5,6,6,1
2880,6715,37,35,96,96,61
2881,6716,20,26,32,32,6
2882,6720,14,16,17,16,0
2883,6721,15,40,44,43,3
2884,6724,19,21,27,22,1
2885,6726,10,25,35,33,8
2886,6727,21,33,33,33,0
2887,6729,9,43,53,49,6
2888,6730,16,28,33,29,1
2889,6734,8,43,46,46,3
2890,6736,18,44,44,44,0
2891,6739,5,51,67,61,10
2892,6741,14,35,37,35,0
2893,6743,12,41,52,52,11
2894,6745,21,32,33,32,0
2895,6747,4,57,59,58,1
2896,6748,23,26,27,27,1
2897,6749,16,36,37,37,1
2898,6750,11,44,49,46,2
2899,6751,8,46,50,50,4
2900,6762,10,42,50,48,6
2901,6768,16,21,22,22,1
2902,6773,12,39,40,40,1
2903,6774,15,27,37,33,6
2904,6775,17,26,34,34,8
2905,6776,18,17,17,17,0
2906,6778,6,54,58,56,2
2907,6781,6,49,52,51,2
2908,6782,22,31,33,33,2
2909,6786,7,45,60,51,6
2910,6787,16,35,39,39,4
2911,6789,9,56,60,58,2
2912,6792,20,31,34,31,0
2913,6794,20,24,26,26,2
2914,6796,14,20,23,23,3
2915,6797,8,17,18,18,1
2916,6804,9,31,37,33,2
2917,6805,16,37,38,38,1
2918,6807,18,35,37,37,2
2919,6809,7,46,50,49,3
2920,6812,13,35,37,37,2
2921,6813,17,25,48,35,10
2922,6814,21,28,31,29,1
2923,6819,4,57,67,63,6
2924,6821,10,48,50,50,2
2925,6822,11,39,43,43,4
2926,6824,20,31,31,31,0
2927,6825,11,30,45,41,11
2928,6826,8,44,55,52,8
2929,6827,25,35,37,37,2
2930,6831,13,36,37,37,1
2931,6833,15,31,36,36,5
2932,6834,3,45,71,69,24
2933,6842,9,53,60,60,7
2934,6846,11,38,49,46,8
2935,6847,16,33,43,36,3
2936,6848,20,21,22,22,1
2937,6851,17,30,34,33,3
2938,6862,4,45,52,51,6
2939,6863,10,42,43,42,0
2940,6868,7,51,57,56,5
2941,6874,13,44,46,45,1
2942,6876,15,35,42,40,5
2943,6877,18,24,26,25,1
2944,6878,15,36,37,37,1
2945,6879,12,31,43,34,3
2946,6880,16,42,52,46,4
2947,6883,13,34,54,52,18
2948,6884,15,15,15,15,0
2949,6886,20,22,22,22,0
2950,6891,10,48,53,50,2
2951,6892,8,41,47,46,5
2952,6893,14,33,35,34,1
2953,6896,13,45,53,53,8
2954,6897,4,31,38,36,5
2955,6908,20,30,36,36,6
2956,6909,10,35,42,41,6
2957,6914,14,34,36,36,2
2958,6919,13,35,41,41,6
2959,6927,16,39,41,41,2
2960,6929,5,45,53,52,7
2961,6930,13,36,42,41,5
2962,6933,12,35,42,41,6
2963,6934,16,26,35,28,2
2964,6936,3,1,4,2,1
2965,6937,3,62,67,65,3
2966,6938,12,30,42,37,7
2967,6939,8,41,48,48,7
2968,6940,11,45,51,51,6
2969,6941,17,32,39,32,0
2970,6945,12,47,54,53,6
2971,6947,20,22,27,25,3
2972,6948,15,34,39,38,4
2973,6949,8,14,23,17,3
2974,6951,14,37,37,37,0
2975,6953,13,39,43,42,3
2976,6955,15,40,44,44,4
2977,6959,19,18,19,19,1
2978,6960,24,33,36,35,2
2979,6961,29,33,33,33,0
2980,6962,9,35,40,39,4
2981,6964,12,41,48,46,5
2982,6965,11,37,43,43,6
2983,6966,9,41,47,46,5
2984,6968,9,41,46,46,5
2985,6978,11,45,47,46,1
2986,6979,11,45,45,45,0
2987,6984,10,43,50,49,6
2988,6985,13,43,49,49,6
2989,6986,11,47,49,48,1
2990,6987,13,30,33,31,1
2991,6992,17,35,37,37,2
2992,6995,8,51,55,55,4
2993,6997,14,33,40,38,5
2994,6999,18,40,43,41,1
2995,7000,8,49,50,49,0
2996,7001,21,28,32,30,2
2997,7006,12,27,28,28,1
2998,7007,12,11,11,11,0
2999,7010,7,49,53,53,4
3000,7012,11,39,43,43,4
3001,7013,15,13,14,14,1
3002,7014,10,48,52,51,3
3003,7020,15,37,39,39,2
3004,7022,12,35,36,36,1
3005,7025,14,38,48,43,5
3006,7027,13,44,45,45,1
3007,7034,8,51,52,52,1
3008,7039,19,30,33,33,3
3009,7040,8,46,51,51,5
3010,7041,15,35,42,41,6
3011,7042,17,14,17,17,3
3012,7043,4,43,52,51,8
3013,7051,12,41,47,44,3
3014,7052,10,17,19,17,0
3015,7054,22,29,33,33,4
3016,7056,18,25,29,29,4
3017,7057,24,24,26,25,1
3018,7058,19,24,25,25,1
3019,7061,21,28,31,30,2
3020,7066,14,42,48,47,5
3021,7069,15,39,44,42,3
3022,7073,11,40,46,45,5
3023,7074,16,37,41,41,4
3024,7075,16,30,35,34,4
3025,7082,7,48,55,53,5
3026,7083,5,61,67,66,5
3027,7086,14,34,36,36,2
3028,7087,6,45,52,51,6
3029,7088,23,22,23,23,1
3030,7089,11,10,10,10,0
3031,7090,7,43,47,47,4
3032,7092,22,24,26,26,2
3033,7093,10,48,56,55,7
3034,7094,18,36,36,36,0
3035,7095,9,31,52,44,13
3036,7096,17,22,23,23,1
3037,7097,21,18,21,20,2
3038,7101,8,54,61,61,7
3039,7103,14,45,48,47,2
3040,7104,15,32,39,34,2
3041,7105,12,39,46,46,7
3042,7107,8,52,60,59,7
3043,7113,3,11,11,11,0
3044,7114,8,35,54,49,14
3045,7116,17,20,26,21,1
3046,7117,20,20,22,22,2
3047,7118,12,44,48,48,4
3048,7123,16,21,28,25,4
3049,7125,17,44,46,44,0
3050,7133,8,51,55,55,4
3051,7138,11,46,47,47,1
3052,7141,17,32,41,39,7
3053,7143,3,53,60,60,7
3054,7144,8,41,42,42,1
3055,7145,15,24,47,27,3
3056,7147,17,41,43,43,2
3057,7148,18,29,29,29,0
3058,7156,4,56,66,63,7
3059,7159,18,29,32,32,3
3060,7169,15,13,15,14,1
3061,7170,22,33,34,33,0
3062,7178,18,24,48,34,10
3063,7182,14,28,29,29,1
3064,7188,12,39,47,46,7
3065,7190,5,56,58,58,2
3066,7192,12,27,33,32,5
3067,7194,16,20,29,24,4
3068,7195,13,38,44,44,6
3069,7196,8,49,50,49,0
3070,7197,4,7,7,7,0
3071,7198,23,26,26,26,0
3072,7204,6,51,59,58,7
3073,7205,13,19,54,40,21
3074,7206,1,52,63,61,9
3075,7208,20,26,27,27,1
3076,7210,13,19,22,21,2
3077,7214,10,44,47,45,1
3078,7216,7,40,51,49,9
3079,7217,7,39,46,44,5
3080,7218,20,24,24,24,0
3081,7220,17,19,25,20,1
3082,7221,10,44,47,46,2
3083,7223,6,58,58,58,0
3084,7227,11,27,34,31,4
3085,7229,16,35,41,40,5
3086,7231,5,57,68,63,6
3087,7234,13,11,12,12,1
3088,7236,5,53,62,62,9
3089,7238,9,32,34,33,1
3090,7244,17,20,24,23,3
3091,7245,5,3,4,3,0
3092,7246,15,22,22,22,0
3093,7247,15,44,45,45,1
3094,7248,5,47,52,52,5
3095,7251,18,38,44,44,6
3096,7254,8,51,53,51,0
3097,7258,17,10,25,17,7
3098,7261,8,26,36,36,10
3099,7265,21,33,34,34,1
3100,7266,9,44,51,49,5
3101,7268,22,25,28,28,3
3102,7271,13,10,12,12,2
3103,7273,11,37,44,44,7
3104,7274,15,8,19,9,1
3105,7275,6,38,38,38,0
3106,7277,20,18,20,19,1
3107,7279,11,42,45,45,3
3108,7280,16,29,35,34,5
3109,7281,18,27,30,30,3
3110,7294,18,30,30,30,0
3111,7298,13,44,58,48,4
3112,7302,17,30,31,31,1
3113,7303,10,12,18,15,3
3114,7305,7,51,54,54,3
3115,7306,11,19,33,32,13
3116,7308,21,23,23,23,0
3117,7312,18,17,18,18,1
3118,7319,17,29,29,29,0
3119,7320,26,26,39,38,12
3120,7322,19,24,26,26,2
3121,7323,22,34,36,36,2
3122,7324,19,35,40,39,4
3123,7326,12,38,41,40,2
3124,7328,18,30,33,32,2
3125,7332,18,6,20,8,2
3126,7336,9,17,35,28,11
3127,7341,27,31,38,33,2
3128,7343,6,53,62,57,4
3129,7352,2,59,62,62,3
3130,7355,15,37,44,41,4
3131,7359,16,31,37,37,6
3132,7363,4,58,61,61,3
3133,7365,11,21,27,25,4
3134,7366,3,49,55,53,4
3135,7369,4,50,64,62,12
3136,7371,12,29,32,31,2
3137,7373,14,44,46,46,2
3138,7375,10,42,57,52,10
3139,7376,22,25,27,27,2
3140,7381,15,19,20,20,1
3141,7393,8,43,49,48,5
3142,7397,18,21,22,22,1
3143,7402,13,38,43,43,5
3144,7404,14,25,34,27,2
3145,7406,11,30,49,43,13
3146,7411,7,43,51,50,7
3147,7414,9,35,38,38,3
3148,7422,4,57,58,58,1
3149,7428,11,34,45,43,9
3150,7430,6,52,58,57,5
3151,7435,17,20,26,24,4
3152,7439,7,22,28,24,2
3153,7440,8,42,52,49,7
3154,7446,19,35,39,37,2
3155,7447,8,38,45,43,5
3156,7448,13,36,37,37,1
3157,7460,17,32,35,33,1
3158,7461,17,36,40,39,3
3159,7464,18,27,35,31,4
3160,7465,19,36,40,39,3
3161,7469,9,34,43,42,8
3162,7480,7,50,56,55,5
3163,7484,11,39,43,43,4
3164,7486,22,24,30,27,3
3165,7488,11,18,46,23,5
3166,7496,17,39,46,44,5
3167,7497,19,16,22,18,2
3168,7499,11,27,36,32,5
3169,7502,20,33,37,36,3
3170,7504,19,33,36,36,3
3171,7505,15,21,24,23,2
3172,7508,15,26,34,31,5
3173,7518,18,37,37,37,0
3174,7519,12,26,33,31,5
3175,7522,19,24,25,25,1
3176,7525,13,33,37,36,3
3177,7526,9,44,49,48,4
3178,7530,7,50,58,56,6
3179,7537,19,19,20,20,1
3180,7542,11,9,10,10,1
3181,7544,6,22,23,23,1
3182,7545,19,21,23,23,2
3183,7549,10,48,62,60,12
3184,7550,13,24,26,25,1
3185,7552,13,37,43,43,6
3186,7554,11,46,52,50,4
3187,7558,17,25,27,26,1
3188,7559,16,25,32,29,4
3189,7566,25,33,38,38,5
3190,7568,21,32,38,34,2
3191,7569,16,17,18,18,1
3192,7573,17,21,24,23,2
3193,7578,6,49,58,56,7
3194,7579,9,52,56,56,4
3195,7580,7,56,60,59,3
3196,7582,8,38,40,40,2
3197,7583,8,37,44,44,7
3198,7584,13,42,44,44,2
3199,7585,8,53,55,55,2
3200,7588,15,41,41,41,0
3201,7590,14,50,53,53,3
3202,7592,6,34,38,36,2
3203,7593,14,38,41,41,3
3204,7596,7,31,36,35,4
3205,7599,8,48,60,56,8
3206,7600,11,38,42,42,4
3207,7611,13,13,18,16,3
3208,7612,18,24,25,24,0
3209,7619,19,30,36,33,3
3210,7622,13,17,26,23,6
3211,7623,9,35,36,36,1
3212,7624,14,32,42,40,8
3213,7625,3,64,67,67,3
3214,7628,2,56,68,64,8
3215,7630,18,30,31,30,0
3216,7632,11,40,46,45,5
3217,7633,13,38,39,39,1
3218,7634,5,25,29,28,3
3219,7635,7,51,53,53,2
3220,7638,10,48,49,49,1
3221,7639,10,53,54,54,1
3222,7641,4,62,85,80,18
3223,7645,18,21,32,30,9
3224,7649,4,61,68,65,4
3225,7651,14,43,46,45,2
3226,7658,17,41,46,45,4
3227,7660,17,39,42,42,3
3228,7662,4,53,57,56,3
3229,7663,5,62,64,64,2
3230,7665,6,45,52,52,7
3231,7666,19,19,20,20,1
3232,7667,8,41,48,48,7
3233,7668,8,48,48,48,0
3234,7669,3,66,68,67,1
3235,7672,17,30,40,36,6
3236,7676,8,42,51,48,6
3237,7680,9,46,48,48,2
3238,7681,8,27,31,28,1
3239,7685,20,15,25,19,4
3240,7690,14,50,53,52,2
3241,7692,8,41,47,47,6
3242,7697,16,24,29,29,5
3243,7700,18,35,36,36,1
3244,7701,2,63,79,77,14
3245,7703,17,34,41,40,6
3246,7705,16,39,42,42,3
3247,7709,11,25,27,26,1
3248,7711,8,49,52,52,3
3249,7712,6,53,56,56,3
3250,7713,5,39,40,40,1
3251,7714,7,55,61,61,6
3252,7715,12,33,38,35,2
3253,7717,12,37,39,38,1
3254,7718,11,56,58,58,2
3255,7719,14,41,43,43,2
3256,7721,11,41,44,44,3
3257,7723,14,37,39,39,2
3258,7724,11,50,55,54,4
3259,7728,21,26,27,26,0
3260,7730,13,31,38,37,6
3261,7734,18,28,28,28,0
3262,7735,11,41,44,43,2
3263,7737,12,46,56,56,10
3264,7738,17,29,30,30,1
3265,7742,18,29,30,30,1
3266,7744,5,47,61,61,14
3267,7745,14,39,43,43,4
3268,7747,13,40,40,40,0
3269,7749,18,30,36,36,6
3270,7750,4,67,80,78,11
3271,7751,17,22,25,24,2
3272,7753,14,41,45,44,3
3273,7754,9,36,40,40,4
3274,7755,11,40,51,47,7
3275,7756,13,34,39,39,5
3276,7757,12,12,16,13,1
3277,7758,10,38,43,42,4
3278,7760,13,36,36,36,0
3279,7763,4,57,66,61,4
3280,7764,14,24,28,27,3
3281,7766,11,46,47,47,1
3282,7767,7,37,42,40,3
3283,7771,7,47,51,49,2
3284,7772,17,38,40,40,2
3285,7774,2,69,79,73,4
3286,7775,12,26,27,27,1
3287,7784,7,59,67,65,6
3288,7785,15,39,41,41,2
3289,7786,20,29,30,30,1
3290,7789,6,52,57,57,5
3291,7790,9,27,36,32,5
3292,7792,19,31,39,36,5
3293,7794,8,64,69,69,5
3294,7796,8,46,54,54,8
3295,7797,14,35,35,35,0
3296,7798,8,50,53,53,3
3297,7800,9,53,53,53,0
3298,7801,12,41,45,44,3
3299,7802,15,32,34,34,2
3300,7806,15,39,40,40,1
3301,7808,9,41,45,45,4
3302,7816,6,56,60,57,1
3303,7817,16,31,33,33,2
3304,7819,7,52,56,54,2
3305,7820,19,40,44,42,2
3306,7821,15,38,41,41,3
3307,7822,6,56,59,59,3
3308,7823,12,35,46,42,7
3309,7824,3,53,58,56,3
3310,7825,11,45,47,47,2
3311,7826,3,54,64,64,10
3312,7829,13,37,43,43,6
3313,7830,5,58,61,59,1
3314,7831,4,59,64,64,5
3315,7833,6,41,56,55,14
3316,7842,8,42,44,44,2
3317,7843,11,42,61,60,18
3318,7844,12,11,12,12,1
3319,7847,12,42,45,45,3
3320,7848,17,15,17,15,0
3321,7849,10,38,42,41,3
3322,7850,10,44,44,44,0
3323,7854,8,40,44,44,4
3324,7856,4,43,50,49,6
3325,7858,12,34,44,41,7
3326,7860,5,58,61,61,3
3327,7861,17,27,33,31,4
3328,7864,14,38,41,40,2
3329,7865,2,63,65,65,2
3330,7868,9,47,48,48,1
3331,7869,19,22,23,23,1
3332,7870,10,50,50,50,0
3333,7876,13,46,48,48,2
3334,7877,6,56,60,60,4
3335,7879,13,29,36,36,7
3336,7882,16,42,44,44,2
3337,7883,9,37,48,41,4
3338,7884,8,56,62,61,5
3339,7885,11,28,37,34,6
3340,7886,18,30,41,33,3
3341,7888,15,35,38,38,3
3342,7889,3,57,62,62,5
3343,7890,16,36,43,43,7
3344,7891,10,46,47,47,1
3345,7892,10,52,52,52,0
3346,7894,6,77,81,81,4
3347,7898,25,28,30,30,2
3348,7902,4,58,74,71,13
3349,7904,10,22,27,27,5
3350,7905,22,33,36,36,3
3351,7908,9,40,46,44,4
3352,7910,19,34,38,36,2
3353,7912,24,21,23,23,2
3354,7913,5,69,80,79,10
3355,7915,6,45,47,47,2
3356,7916,10,45,47,47,2
3357,7917,8,7,10,8,1
3358,7920,6,60,62,62,2
3359,7921,8,50,57,54,4
3360,7922,14,13,14,14,1
3361,7924,5,52,54,54,2
3362,7929,7,46,47,47,1
3363,7932,16,38,39,39,1
3364,7936,16,32,37,37,5
3365,7942,10,41,43,42,1
3366,7943,9,42,44,43,1
3367,7944,14,41,43,43,2
3368,7947,12,41,45,43,2
3369,7951,6,55,62,60,5
3370,7952,4,65,69,69,4
3371,7953,10,41,49,47,6
3372,7955,15,31,39,36,5
3373,7956,8,44,50,47,3
3374,7957,7,57,64,64,7
3375,7958,5,48,50,48,0
3376,7959,10,56,60,59,3
3377,7960,16,12,34,21,9
3378,7962,4,63,79,78,15
3379,7963,8,9,12,10,1
3380,7966,11,45,46,46,1
3381,7967,7,30,38,37,7
3382,7968,6,4,10,6,2
3383,7971,11,49,55,53,4
3384,7977,5,21,22,21,0
3385,7981,9,51,54,52,1
3386,7982,11,36,37,37,1
3387,7986,14,39,43,43,4
3388,7988,16,26,30,29,3
3389,7989,21,30,31,31,1
3390,7990,2,60,72,71,11
3391,7991,17,40,43,43,3
3392,7992,12,31,33,33,2
3393,7994,10,40,51,48,8
3394,7995,19,39,43,43,4
3395,7996,4,35,43,39,4
3396,7998,23,39,39,39,0
3397,7999,18,15,19,18,3
3398,8000,12,51,57,56,5
3399,8002,17,31,32,32,1
3400,8003,14,13,13,13,0
3401,8004,10,37,49,48,11
3402,8009,18,38,45,44,6
3403,8011,10,50,50,50,0
3404,8016,11,43,43,43,0
3405,8017,19,31,39,39,8
3406,8022,16,43,46,46,3
3407,8023,8,51,56,55,4
3408,8025,10,48,53,51,3
3409,8026,11,12,21,18,6
3410,8027,10,30,36,33,3
3411,8028,22,37,39,39,2
3412,8029,10,40,42,42,2
3413,8031,11,54,59,56,2
3414,8032,16,30,34,33,3
3415,8034,7,44,47,47,3
3416,8038,5,44,58,53,9
3417,8039,12,34,35,35,1
3418,8040,5,49,60,60,11
3419,8041,23,27,33,32,5
3420,8042,11,40,44,43,3
3421,8043,8,27,29,29,2
3422,8046,16,42,45,44,2
3423,8048,12,45,45,45,0
3424,8049,9,50,56,55,5
3425,8050,9,52,52,52,0
3426,8051,18,36,38,38,2
3427,8052,6,23,33,28,5
3428,8053,10,43,45,45,2
3429,8055,6,43,60,58,15
3430,8062,14,41,48,47,6
3431,8064,5,58,65,63,5
3432,8065,13,40,40,40,0
3433,8067,8,32,53,40,8
3434,8073,23,38,39,39,1
3435,8074,15,35,38,38,3
3436,8075,17,16,17,17,1
3437,8077,8,52,63,62,10
3438,8079,21,20,23,20,0
3439,8081,9,43,52,50,7
3440,8082,3,56,63,62,6
3441,8083,9,27,41,40,13
3442,8086,3,44,47,47,3
3443,8087,5,62,65,65,3
3444,8088,12,17,17,17,0
3445,8089,11,44,46,46,2
3446,8093,16,27,34,34,7
3447,8095,13,26,43,38,12
3448,8096,20,28,38,36,8
3449,8097,16,34,38,36,2
3450,8099,15,28,29,29,1
3451,8100,25,36,38,37,1
3452,8102,6,47,56,53,6
3453,8103,10,42,47,46,4
3454,8105,10,33,37,36,3
3455,8106,8,49,59,57,8
3456,8107,13,13,15,14,1
3457,8108,9,50,56,55,5
3458,8111,6,62,63,62,0
3459,8116,10,46,52,51,5
3460,8117,7,43,46,46,3
3461,8119,13,48,49,48,0
3462,8120,11,33,39,37,4
3463,8122,14,35,41,41,6
3464,8123,10,41,44,44,3
3465,8124,5,9,13,10,1
3466,8126,4,56,66,64,8
3467,8130,6,40,51,49,9
3468,8132,19,25,28,28,3
3469,8133,7,41,53,52,11
3470,8134,4,55,58,58,3
3471,8136,5,56,57,56,0
3472,8137,8,50,56,55,5
3473,8138,15,39,46,45,6
3474,8147,11,43,49,46,3
3475,8149,5,53,68,67,14
3476,8150,1,2,3,2,0
3477,8151,11,30,34,34,4
3478,8153,12,44,46,46,2
3479,8154,19,33,34,34,1
3480,8157,9,40,47,47,7
3481,8160,11,40,42,42,2
3482,8163,13,38,42,42,4
3483,8164,9,43,50,49,6
3484,8166,8,42,58,58,16
3485,8167,13,39,43,42,3
3486,8169,6,51,63,63,12
3487,8170,8,60,60,60,0
3488,8171,12,28,32,31,3
3489,8175,12,40,43,43,3
3490,8176,5,52,55,55,3
3491,8178,8,48,64,62,14
3492,8180,23,25,25,25,0
3493,8182,13,24,27,25,1
3494,8184,7,48,49,49,1
3495,8187,18,35,35,35,0
3496,8188,10,42,44,44,2
3497,8189,10,43,49,49,6
3498,8191,12,42,43,43,1
3499,8193,15,43,49,49,6
3500,8194,14,34,45,35,1
3501,8196,5,55,62,61,6
3502,8200,5,43,56,56,13
3503,8202,7,41,43,43,2
3504,8203,5,52,57,55,3
3505,8207,6,9,10,10,1
3506,8210,19,37,38,38,1
3507,8211,16,43,47,47,4
3508,8212,13,31,33,33,2
3509,8214,14,39,43,42,3
3510,8215,20,29,31,31,2
3511,8216,9,40,43,43,3
3512,8217,2,55,68,68,13
3513,8220,11,36,42,41,5
3514,8224,11,43,47,47,4
3515,8226,9,24,25,25,1
3516,8230,18,32,40,36,4
3517,8231,17,30,32,32,2
3518,8232,22,32,38,38,6
3519,8233,22,25,26,26,1
3520,8234,10,30,36,36,6
3521,8236,8,44,48,48,4
3522,8237,7,49,55,55,6
3523,8239,13,31,53,35,4
3524,8241,9,48,53,53,5
3525,8242,14,38,40,40,2
3526,8248,5,53,55,54,1
3527,8249,29,43,65,64,21
3528,8250,4,63,70,67,4
3529,8251,11,44,52,52,8
3530,8256,5,51,57,57,6
3531,8257,2,57,63,61,4
3532,8258,17,29,31,31,2
3533,8260,16,41,43,43,2
3534,8261,23,34,34,34,0
3535,8262,17,38,51,45,7
3536,8264,9,49,58,54,5
3537,8265,4,57,59,59,2
3538,8267,10,52,53,52,0
3539,8268,10,41,44,44,3
3540,8269,10,39,45,45,6
3541,8270,19,26,30,30,4
3542,8277,11,37,38,38,1
3543,8279,12,42,42,42,0
3544,8281,9,40,53,53,13
3545,8283,11,16,21,19,3
3546,8284,7,48,56,51,3
3547,8286,7,30,40,39,9
3548,8287,8,48,50,50,2
3549,8288,13,40,42,42,2
3550,8290,22,37,38,38,1
3551,8291,13,32,37,35,3
3552,8296,18,28,35,33,5
3553,8301,11,45,53,53,8
3554,8302,4,45,53,50,5
3555,8305,11,42,49,49,7
3556,8308,12,42,46,45,3
3557,8310,12,38,42,41,3
3558,8311,5,57,81,81,24
3559,8313,12,43,46,46,3
3560,8314,7,38,41,41,3
3561,8315,4,59,68,67,8
3562,8319,6,2,11,2,0
3563,8321,9,46,71,62,16
3564,8325,8,51,56,56,5
3565,8327,11,2,29,3,1
3566,8328,13,32,33,33,1
3567,8330,2,51,57,57,6
3568,8331,8,48,54,53,5
3569,8337,12,46,51,50,4
3570,8338,18,23,28,25,2
3571,8339,15,46,47,47,1
3572,8344,21,33,39,37,4
3573,8352,8,48,49,49,1
3574,8354,14,27,37,35,8
3575,8360,5,48,51,50,2
3576,8363,13,40,45,45,5
3577,8364,6,51,57,57,6
3578,8365,4,34,38,37,3
3579,8366,13,41,46,46,5
3580,8368,4,51,60,60,9
3581,8371,12,14,14,14,0
3582,8373,12,45,49,49,4
3583,8374,9,46,48,48,2
3584,8376,14,41,46,45,4
3585,8379,3,56,67,67,11
3586,8380,9,48,52,51,3
3587,8381,7,51,63,60,9
3588,8382,24,24,29,29,5
3589,8383,11,47,50,50,3
3590,8385,21,24,27,27,3
3591,8387,14,27,39,35,8
3592,8388,13,21,25,25,4
3593,8391,15,38,43,41,3
3594,8393,7,49,52,52,3
3595,8394,3,47,57,56,9
3596,8396,12,49,51,50,1
3597,8398,20,31,33,32,1
3598,8399,16,33,36,35,2
3599,8401,1,69,73,73,4
3600,8402,7,54,54,54,0
3601,8403,6,52,67,67,15
3602,8405,8,44,52,51,7
3603,8411,11,11,14,12,1
3604,8413,12,36,36,36,0
3605,8415,12,33,38,37,4
3606,8416,17,23,23,23,0
3607,8419,14,38,42,42,4
3608,8422,8,53,64,62,9
3609,8423,13,34,40,40,6
3610,8428,13,32,37,35,3
3611,8429,8,48,49,49,1
3612,8430,13,33,36,36,3
3613,8431,18,29,33,33,4
3614,8433,22,39,42,40,1
3615,8435,4,61,63,63,2
3616,8440,8,55,61,60,5
3617,8441,3,56,63,61,5
3618,8444,9,45,47,47,2
3619,8445,15,26,29,28,2
3620,8446,11,47,56,55,8
3621,8447,8,50,56,54,4
3622,8450,17,41,44,42,1
3623,8451,6,58,71,71,13
3624,8452,11,47,48,48,1
3625,8453,12,37,53,41,4
3626,8456,14,16,19,16,0
3627,8457,26,36,36,36,0
3628,8458,8,54,58,57,3
3629,8460,5,52,62,62,10
3630,8461,4,59,60,60,1
3631,8466,26,30,32,31,1
3632,8467,11,45,52,52,7
3633,8470,8,56,58,56,0
3634,8473,16,40,44,41,1
3635,8476,10,26,31,30,4
3636,8477,17,13,28,25,12
3637,8478,8,33,47,45,12
3638,8482,5,30,35,34,4
3639,8483,9,45,46,46,1
3640,8485,4,69,72,72,3
3641,8486,12,44,46,45,1
3642,8487,18,34,38,38,4
3643,8490,13,39,44,44,5
3644,8491,28,18,55,47,29
3645,8492,16,21,42,30,9
3646,8493,11,25,37,34,9
3647,8495,6,45,50,49,4
3648,8496,7,49,54,53,4
3649,8497,18,30,31,31,1
3650,8498,15,38,40,39,1
3651,8501,5,55,59,58,3
3652,8502,10,50,52,51,1
3653,8503,14,27,32,32,5
3654,8505,10,37,53,53,16
3655,8506,86,32,116,113,81
3656,8507,6,60,63,63,3
3657,8508,9,36,38,37,1
3658,8512,11,50,54,54,4
3659,8514,10,43,47,47,4
3660,8518,3,59,61,61,2
3661,8519,18,23,38,37,14
3662,8520,8,51,52,51,0
3663,8523,8,53,56,56,3
3664,8524,7,48,52,52,4
3665,8530,20,36,38,38,2
3666,8531,8,57,63,62,5
3667,8533,19,40,42,41,1
3668,8535,5,51,54,54,3
3669,8538,11,44,46,46,2
3670,8541,12,43,43,43,0
3671,8542,12,49,49,49,0
3672,8543,3,57,68,67,10
3673,8545,9,55,57,57,2
3674,8546,10,8,10,9,1
3675,8547,7,53,59,57,4
3676,8548,6,52,54,54,2
3677,8550,2,64,73,72,8
3678,8551,7,45,48,47,2
3679,8552,12,35,47,47,12
3680,8555,15,37,39,39,2
3681,8558,6,53,63,61,8
3682,8561,22,30,34,34,4
3683,8563,15,32,36,36,4
3684,8568,10,44,47,47,3
3685,8569,12,40,43,43,3
3686,8575,14,36,47,47,11
3687,8576,5,48,55,53,5
3688,8581,19,40,43,43,3
3689,8582,15,34,37,37,3
3690,8583,10,45,46,45,0
3691,8584,11,42,51,49,7
3692,8585,12,47,58,55,8
3693,8587,14,47,51,51,4
3694,8591,7,53,57,57,4
3695,8593,11,35,42,40,5
3696,8594,17,33,38,37,4
3697,8599,8,48,52,51,3
3698,8600,36,13,57,57,44
3699,8605,15,33,35,34,1
3700,8606,3,55,68,67,12
3701,8607,16,35,38,37,2
3702,8608,7,50,53,53,3
3703,8610,15,26,27,27,1
3704,8618,11,43,44,44,1
3705,8620,16,33,34,34,1
3706,8621,5,53,58,58,5
3707,8624,15,36,36,36,0
3708,8625,7,55,60,60,5
3709,8627,15,35,36,36,1
3710,8628,17,34,34,34,0
3711,8629,13,43,47,47,4
3712,8630,12,41,44,44,3
3713,8631,6,55,66,62,7
3714,8632,17,30,34,34,4
3715,8636,7,56,67,67,11
3716,8638,7,44,46,46,2
3717,8639,8,32,39,35,3
3718,8641,9,46,52,52,6
3719,8643,4,55,63,63,8
3720,8644,14,37,60,41,4
3721,8645,6,46,54,54,8
3722,8646,10,41,44,42,1
3723,8648,5,63,68,68,5
3724,8654,8,41,42,42,1
3725,8656,9,47,54,53,6
3726,8657,15,28,49,37,9
3727,8658,12,49,50,50,1
3728,8659,9,42,49,48,6
3729,8660,4,45,77,63,18
3730,8661,4,59,60,60,1
3731,8662,13,40,50,50,10
3732,8663,8,54,59,57,3
3733,8666,7,49,55,54,5
3734,8670,10,46,49,49,3
3735,8671,12,46,47,47,1
3736,8672,19,27,29,29,2
3737,8675,14,47,50,49,2
3738,8678,4,50,60,60,10
3739,8679,2,60,66,64,4
3740,8680,9,51,56,56,5
3741,8684,15,35,37,37,2
3742,8686,14,33,35,35,2
3743,8690,8,10,21,15,5
3744,8693,7,45,48,47,2
3745,8694,5,54,57,57,3
3746,8696,11,27,27,27,0
3747,8697,6,53,61,59,6
3748,8698,7,43,44,43,0
3749,8699,7,51,54,54,3
3750,8701,7,42,43,42,0
3751,8702,15,36,40,40,4
3752,8703,16,37,40,40,3
3753,8704,7,44,55,54,10
3754,8706,7,44,46,46,2
3755,8708,8,36,48,47,11
3756,8709,20,23,23,23,0
3757,8713,10,45,47,47,2
3758,8714,4,58,60,59,1
3759,8715,20,33,35,35,2
3760,8717,2,57,65,65,8
3761,8718,7,62,65,64,2
3762,8719,2,57,63,63,6
3763,8720,6,68,69,69,1
3764,8721,17,19,23,20,1
3765,8723,25,32,33,33,1
3766,8724,10,16,25,22,6
3767,8725,21,32,33,33,1
3768,8727,4,49,57,55,6
3769,8728,20,34,36,36,2
3770,8729,1,49,55,55,6
3771,8730,19,26,39,32,6
3772,8734,15,38,43,43,5
3773,8735,15,22,30,29,7
3774,8737,6,31,35,35,4
3775,8738,8,54,56,56,2
3776,8739,10,38,43,43,5
3777,8740,16,31,36,36,5
3778,8741,7,49,57,55,6
3779,8742,18,39,44,43,4
3780,8743,20,25,25,25,0
3781,8745,29,26,30,30,4
3782,8749,13,43,47,47,4
3783,8750,27,28,30,29,1
3784,8751,7,61,63,62,1
3785,8757,12,38,39,39,1
3786,8758,9,38,51,44,6
3787,8760,8,57,60,60,3
3788,8762,6,51,58,58,7
3789,8765,14,41,44,44,3
3790,8768,11,47,50,50,3
3791,8769,20,36,38,38,2
3792,8771,19,33,42,39,6
3793,8772,13,39,51,51,12
3794,8776,14,31,32,32,1
3795,8777,15,42,45,45,3
3796,8782,5,47,61,60,13
3797,8790,18,27,28,28,1
3798,8791,8,40,45,44,4
3799,8793,9,45,51,49,4
3800,8794,19,33,38,37,4
3801,8795,17,36,38,37,1
3802,8797,8,45,49,49,4
3803,8800,9,48,51,51,3
3804,8801,20,29,32,31,2
3805,8803,17,30,32,32,2
3806,8805,8,45,46,46,1
3807,8806,17,42,47,47,5
3808,8807,18,31,33,32,1
3809,8808,18,36,38,37,1
3810,8811,11,44,48,48,4
3811,8812,2,53,59,59,6
3812,8817,4,47,54,53,6
3813,8818,21,30,32,31,1
3814,8820,8,44,53,53,9
3815,8823,6,60,70,69,9
3816,8825,15,44,48,47,3
3817,8827,8,41,44,43,2
3818,8828,8,11,16,14,3
3819,8832,18,26,31,31,5
3820,8833,12,31,55,38,7
3821,8834,4,70,84,82,12
3822,8835,21,28,32,32,4
3823,8837,8,47,52,51,4
3824,8838,7,31,43,39,8
3825,8843,13,45,47,46,1
3826,8844,12,19,27,22,3
3827,8845,20,28,32,30,2
3828,8846,13,37,44,43,6
3829,8847,7,59,60,60,1
3830,8848,16,15,19,17,2
3831,8850,10,48,52,49,1
3832,8851,5,63,68,67,4
3833,8852,3,53,55,54,1
3834,8854,15,33,39,34,1
3835,8855,17,35,41,40,5
3836,8856,13,28,34,34,6
3837,8857,5,63,79,79,16
3838,8858,8,41,47,47,6
3839,8859,20,26,30,30,4
3840,8862,6,46,57,52,6
3841,8864,20,37,40,40,3
3842,8870,10,11,17,16,5
3843,8874,7,54,57,56,2
3844,8875,5,50,54,54,4
3845,8877,13,34,38,38,4
3846,8878,3,63,72,70,7
3847,8879,14,37,42,41,4
3848,8884,16,41,43,42,1
3849,8887,12,45,47,46,1
3850,8894,7,40,43,42,2
3851,8895,9,46,51,51,5
3852,8897,14,35,35,35,0
3853,8898,21,22,23,23,1
3854,8899,14,38,49,44,6
3855,8900,9,41,47,46,5
3856,8901,7,56,58,58,2
3857,8902,15,26,28,28,2
3858,8905,3,52,74,73,21
3859,8909,9,47,53,53,6
3860,8910,5,54,62,61,7
3861,8911,10,42,49,49,7
3862,8913,7,46,48,48,2
3863,8917,3,52,61,61,9
3864,8918,7,62,67,67,5
3865,8920,15,29,33,31,2
3866,8921,7,48,54,54,6
3867,8922,4,58,63,62,4
3868,8923,6,54,59,58,4
3869,8924,17,15,19,16,1
3870,8927,15,34,40,39,5
3871,8928,17,38,46,46,8
3872,8929,7,50,52,51,1
3873,8931,4,2,5,2,0
3874,8933,13,35,41,40,5
3875,8934,9,43,47,47,4
3876,8940,12,43,50,47,4
3877,8944,10,52,59,58,6
3878,8945,9,47,49,49,2
3879,8946,11,54,67,65,11
3880,8947,11,43,46,46,3
3881,8949,16,33,37,37,4
3882,8951,6,65,66,66,1
3883,8952,7,65,70,69,4
3884,8953,11,42,42,42,0
3885,8954,14,35,38,37,2
3886,8955,17,26,30,29,3
3887,8956,17,31,34,34,3
3888,8957,1,57,61,60,3
3889,8958,21,32,36,34,2
3890,8959,8,30,38,34,4
3891,8960,10,45,46,46,1
3892,8968,9,43,47,47,4
3893,8969,8,52,54,52,0
3894,8973,5,62,66,66,4
3895,8974,17,17,26,23,6
3896,8975,3,57,65,63,6
3897,8980,23,32,32,32,0
3898,8981,9,35,56,44,9
3899,8983,9,34,39,36,2
3900,8986,6,54,66,65,11
3901,8987,10,47,49,49,2
3902,8988,12,43,46,46,3
3903,8989,13,38,44,44,6
3904,8991,12,36,40,40,4
3905,8995,14,46,53,52,6
3906,8996,9,30,39,39,9
3907,8997,24,27,31,31,4
3908,8998,5,54,67,65,11
3909,9000,11,23,24,24,1
3910,9001,11,41,47,46,5
3911,9005,10,46,49,48,2
3912,9006,20,39,45,43,4
3913,9007,18,37,40,40,3
3914,9008,6,49,52,50,1
3915,9009,11,41,46,46,5
3916,9010,10,47,50,50,3
3917,9012,20,35,37,37,2
3918,9013,3,53,59,59,6
3919,9014,20,33,38,37,4
3920,9018,14,41,44,44,3
3921,9021,18,29,32,32,3
3922,9022,12,21,32,29,8
3923,9026,13,30,30,30,0
3924,9029,8,49,63,53,4
3925,9030,15,18,24,23,5
3926,9032,14,42,49,47,5
3927,9033,18,32,37,36,4
3928,9038,14,38,39,39,1
3929,9039,17,35,39,39,4
3930,9040,14,36,44,42,6
3931,9042,20,29,29,29,0
3932,9045,17,31,38,32,1
3933,9046,7,45,50,50,5
3934,9047,4,52,59,58,6
3935,9049,6,50,58,58,8
3936,9050,6,51,56,56,5
3937,9053,15,16,16,16,0
3938,9054,1,69,73,73,4
3939,9056,5,18,19,19,1
3940,9058,7,63,63,63,0
3941,9060,13,24,30,26,2
3942,9062,7,51,59,55,4
3943,9067,2,53,59,57,4
3944,9068,13,16,21,20,4
3945,9071,9,37,61,43,6
3946,9077,10,41,45,45,4
3947,9078,18,37,42,41,4
3948,9079,3,49,59,59,10
3949,9080,6,45,62,58,13
3950,9081,6,54,56,56,2
3951,9082,5,58,64,63,5
3952,9084,2,64,67,67,3
3953,9085,7,49,64,62,13
3954,9086,16,28,32,31,3
3955,9087,13,39,42,42,3
3956,9091,9,38,40,40,2
3957,9095,5,49,63,61,12
3958,9097,10,54,56,55,1
3959,9099,22,24,27,27,3
3960,9103,19,25,29,28,3
3961,9104,11,38,46,45,7
3962,9105,9,41,49,48,7
3963,9106,12,41,46,46,5
3964,9108,4,79,84,84,5
3965,9109,15,38,41,41,3
3966,9110,7,48,53,52,4
3967,9112,23,22,24,24,2
3968,9113,9,43,49,47,4
3969,9114,15,44,48,47,3
3970,9115,15,27,30,29,2
3971,9117,8,52,54,54,2
3972,9120,5,42,60,55,13
3973,9121,2,43,51,49,6
3974,9127,7,48,56,54,6
3975,9128,19,21,21,21,0
3976,9130,7,6,8,6,0
3977,9132,8,53,55,55,2
3978,9137,6,51,54,52,1
3979,9139,15,46,49,49,3
3980,9141,11,49,51,50,1
3981,9142,16,48,49,48,0
3982,9143,9,44,48,48,4
3983,9145,13,47,49,49,2
3984,9147,11,40,41,41,1
3985,9148,2,69,73,73,4
3986,9152,17,33,36,35,2
3987,9153,17,35,38,37,2
3988,9155,14,45,46,46,1
3989,9157,8,55,66,64,9
3990,9158,16,32,39,37,5
3991,9162,19,41,41,41,0
3992,9163,11,36,38,38,2
3993,9164,19,37,41,40,3
3994,9165,3,58,81,77,19
3995,9170,23,30,31,31,1
3996,9173,8,48,49,48,0
3997,9175,12,46,49,47,1
3998,9177,7,58,62,61,3
3999,9178,9,52,58,58,6
4000,9179,19,33,37,37,4
4001,9180,13,30,33,31,1
4002,9184,15,42,44,43,1
4003,9192,17,37,39,39,2
4004,9197,16,28,33,33,5
4005,9201,19,33,33,33,0
4006,9202,4,57,60,60,3
4007,9203,5,52,55,54,2
4008,9204,18,31,33,33,2
4009,9205,2,57,66,66,9
4010,9209,12,39,49,48,9
4011,9210,11,48,56,50,2
4012,9212,5,53,64,62,9
4013,9214,18,18,18,18,0
4014,9215,6,44,58,58,14
4015,9221,23,38,40,38,0
4016,9224,4,55,64,62,7
4017,9225,20,40,41,41,1
4018,9226,11,41,44,44,3
4019,9230,16,16,29,19,3
4020,9232,8,52,54,54,2
4021,9233,7,46,52,52,6
4022,9236,6,53,70,68,15
4023,9237,8,38,40,39,1
4024,9241,16,34,36,36,2
4025,9244,16,40,43,42,2
4026,9248,14,36,38,38,2
4027,9249,8,31,40,36,5
4028,9253,5,48,55,55,7
4029,9254,7,50,56,55,5
4030,9256,13,40,46,45,5
4031,9258,16,29,31,31,2
4032,9259,5,47,52,51,4
4033,9260,18,22,22,22,0
4034,9261,13,22,61,46,24
4035,9262,16,37,38,38,1
4036,9267,12,44,51,50,6
4037,9269,13,38,43,41,3
4038,9271,13,45,47,47,2
4039,9274,5,56,58,58,2
4040,9275,21,17,20,19,2
4041,9276,4,64,64,64,0
4042,9277,5,1,8,1,0
4043,9278,13,35,38,38,3
4044,9279,13,42,44,44,2
4045,9284,8,36,37,37,1
4046,9285,13,31,36,34,3
4047,9289,13,43,44,43,0
4048,9290,16,37,43,43,6
4049,9291,18,29,31,31,2
4050,9292,14,44,48,48,4
4051,9293,11,46,50,49,3
4052,9296,22,30,32,31,1
4053,9299,13,42,50,49,7
4054,9301,13,23,32,28,5
4055,9303,12,21,83,70,49
4056,9304,17,31,36,36,5
4057,9305,10,52,54,54,2
4058,9307,14,31,34,33,2
4059,9312,17,29,34,33,4
4060,9313,14,39,40,40,1
4061,9317,9,36,38,37,1
4062,9318,10,43,43,43,0
4063,9320,3,69,82,78,9
4064,9321,8,53,57,56,3
4065,9323,4,54,73,72,18
4066,9325,3,79,85,84,5
4067,9327,12,46,50,49,3
4068,9329,3,49,54,54,5
4069,9330,4,47,51,51,4
4070,9332,2,12,31,15,3
4071,9337,11,47,55,55,8
4072,9338,14,41,43,43,2
4073,9339,7,62,66,65,3
4074,9340,18,32,35,35,3
4075,9341,11,45,49,48,3
4076,9347,14,28,34,34,6
4077,9349,22,36,39,37,1
4078,9350,8,38,46,45,7
4079,9353,11,30,33,33,3
4080,9355,4,44,90,78,34
4081,9358,9,51,56,56,5
4082,9359,16,43,45,45,2
4083,9360,13,46,46,46,0
4084,9361,7,49,57,56,7
4085,9363,12,41,43,43,2
4086,9364,22,33,34,33,0
4087,9367,3,51,59,57,6
4088,9368,14,21,37,34,13
4089,9370,13,37,43,42,5
4090,9372,3,57,62,59,2
4091,9373,12,39,47,46,7
4092,9375,21,33,36,35,2
4093,9376,10,46,54,51,5
4094,9377,7,37,41,39,2
4095,9382,8,50,55,55,5
4096,9383,13,20,20,20,0
4097,9384,6,42,45,45,3
4098,9385,10,41,51,51,10
4099,9389,14,42,46,45,3
4100,9390,9,51,53,53,2
4101,9392,19,33,36,36,3
4102,9393,17,46,48,48,2
4103,9394,11,29,32,31,2
4104,9398,12,48,55,52,4
4105,9399,14,24,32,30,6
4106,9400,4,61,81,77,16
4107,9401,5,52,65,60,8
4108,9404,15,26,27,27,1
4109,9405,11,34,42,39,5
4110,9406,17,20,22,22,2
4111,9408,19,34,35,35,1
4112,9409,17,27,33,31,4
4113,9412,14,37,41,41,4
4114,9416,17,29,30,30,1
4115,9417,14,21,41,37,16
4116,9418,18,40,41,41,1
4117,9421,3,49,56,53,4
4118,9424,4,48,55,54,6
4119,9425,10,24,27,26,2
4120,9426,14,36,42,41,5
4121,9427,21,34,35,35,1
4122,9428,2,53,60,59,6
4123,9430,12,33,37,37,4
4124,9434,4,71,83,83,12
4125,9435,9,41,44,44,3
4126,9440,14,33,38,35,2
4127,9443,13,46,50,49,3
4128,9449,8,45,49,49,4
4129,9450,7,51,60,57,6
4130,9452,13,48,51,51,3
4131,9455,12,46,48,47,1
4132,9457,9,8,11,11,3
4133,9459,4,62,67,64,2
4134,9460,17,22,22,22,0
4135,9462,11,34,40,40,6
4136,9464,6,52,54,53,1
4137,9465,18,33,35,34,1
4138,9467,16,37,47,43,6
4139,9468,3,70,88,84,14
4140,9473,15,33,35,34,1
4141,9475,13,43,45,43,0
4142,9476,2,62,78,77,15
4143,9477,7,47,51,50,3
4144,9478,9,21,27,26,5
4145,9482,20,30,34,34,4
4146,9483,15,47,47,47,0
4147,9485,13,18,20,19,1
4148,9486,8,46,51,51,5
4149,9488,15,34,39,36,2
4150,9494,3,55,61,58,3
4151,9500,2,60,78,77,17
4152,9501,6,48,62,61,13
4153,9503,5,51,53,53,2
4154,9506,3,53,63,62,9
4155,9509,17,19,20,20,1
4156,9510,10,54,57,55,1
4157,9511,11,53,57,56,3
4158,9512,13,28,37,34,6
4159,9514,4,41,55,53,12
4160,9515,12,52,53,53,1
4161,9516,20,33,33,33,0
4162,9521,11,28,37,36,8
4163,9522,6,48,49,49,1
4164,9523,20,21,25,23,2
4165,9524,9,44,49,46,2
4166,9526,7,53,60,59,6
4167,9529,9,28,45,31,3
4168,9532,7,44,47,47,3
4169,9536,4,57,65,65,8
4170,9537,4,51,58,57,6
4171,9539,1,62,71,69,7
4172,9542,10,37,40,40,3
4173,9543,5,52,59,57,5
4174,9544,14,20,21,21,1
4175,9545,4,57,71,68,11
4176,9546,2,57,64,64,7
4177,9548,14,42,45,45,3
4178,9550,24,26,27,27,1
4179,9551,16,53,63,61,8
4180,9553,10,37,42,41,4
4181,9554,11,33,54,50,17
4182,9561,11,46,52,51,5
4183,9562,10,47,48,48,1
4184,9563,22,24,28,28,4
4185,9565,15,34,41,40,6
4186,9566,2,46,51,51,5
4187,9568,9,32,38,35,3
4188,9570,5,55,63,63,8
4189,9572,20,30,31,30,0
4190,9577,6,51,61,54,3
4191,9578,15,41,42,41,0
4192,9579,24,58,97,75,17
4193,9580,5,7,14,10,3
4194,9581,20,37,42,42,5
4195,9582,9,23,55,49,26
4196,9585,6,49,65,60,11
4197,9586,20,27,31,31,4
4198,9591,9,34,40,39,5
4199,9593,19,25,25,25,0
4200,9595,17,37,42,42,5
4201,9598,4,59,61,61,2
4202,9599,7,48,59,59,11
4203,9600,7,38,47,45,7
4204,9602,5,52,58,57,5
4205,9603,12,39,45,43,4
4206,9607,5,45,53,52,7
4207,9610,10,49,52,51,2
4208,9615,10,51,56,54,3
4209,9617,3,54,66,64,10
4210,9618,4,30,32,31,1
4211,9620,15,26,27,27,1
4212,9624,17,34,34,34,0
4213,9628,2,57,65,60,3
4214,9630,15,42,48,48,6
4215,9631,15,39,41,41,2
4216,9632,4,58,65,62,4
4217,9633,6,51,59,58,7
4218,9634,17,20,26,24,4
4219,9635,2,46,56,54,8
4220,9636,8,41,52,52,11
4221,9638,14,28,41,36,8
4222,9640,12,52,56,56,4
4223,9644,10,10,10,10,0
4224,9646,9,53,54,53,0
4225,9649,21,37,40,39,2
4226,9656,9,32,36,35,3
4227,9660,11,43,65,54,11
4228,9663,13,38,40,38,0
4229,9664,18,33,35,35,2
4230,9666,10,51,51,51,0
4231,9667,4,23,28,25,2
4232,9668,1,73,91,88,15
4233,9669,10,42,44,44,2
4234,9670,2,71,82,82,11
4235,9671,14,38,39,39,1
4236,9672,14,13,13,13,0
4237,9673,19,35,40,40,5
4238,9674,10,47,56,54,7
4239,9675,13,35,39,38,3
4240,9676,15,25,28,28,3
4241,9677,13,36,40,40,4
4242,9678,6,54,67,65,11
4243,9679,13,44,50,50,6
4244,9680,17,28,29,29,1
4245,9681,12,41,48,48,7
4246,9682,11,48,58,57,9
4247,9683,15,40,42,41,1
4248,9684,7,10,11,11,1
4249,9686,5,46,48,48,2
4250,9688,10,43,52,52,9
4251,9690,11,16,17,17,1
4252,9691,4,7,11,8,1
4253,9692,6,62,70,69,7
4254,9693,13,21,23,23,2
4255,9694,14,25,27,27,2
4256,9696,14,17,20,20,3
4257,9697,16,36,43,41,5
4258,9698,8,46,49,49,3
4259,9699,9,33,37,36,3
4260,9700,6,53,61,60,7
4261,9701,16,36,37,37,1
4262,9702,11,36,40,39,3
4263,9703,14,22,25,25,3
4264,9704,13,40,49,48,8
4265,9705,12,32,38,37,5
4266,9706,13,33,40,39,6
4267,9707,10,45,52,51,6
4268,9708,8,43,50,50,7
4269,9709,17,27,29,29,2
4270,9710,13,49,52,51,2
4271,9711,7,36,53,42,6
4272,9712,15,26,29,28,2
4273,9713,3,7,8,8,1
4274,9714,10,32,37,37,5
4275,9716,14,35,38,38,3
4276,9717,6,38,50,50,12
4277,9718,11,54,66,62,8
4278,9720,4,82,86,86,4
4279,9721,9,21,21,21,0
4280,9722,17,21,23,22,1
4281,9723,12,32,39,38,6
4282,9724,4,54,66,65,11
4283,9726,10,44,59,58,14
4284,9727,17,39,44,44,5
4285,9728,17,18,19,19,1
4286,9729,13,25,26,25,0
4287,9730,9,44,51,51,7
4288,9732,9,53,59,58,5
4289,9733,9,41,48,48,7
4290,9734,6,69,75,75,6
4291,9736,16,38,39,39,1
4292,9737,7,34,35,35,1
4293,9745,16,27,33,32,5
4294,9747,16,41,46,44,3
4295,9749,20,31,40,36,5
4296,9752,6,39,50,43,4
4297,9758,11,41,51,50,9
4298,9765,18,19,22,21,2
4299,9770,18,16,18,18,2
4300,9771,19,24,47,35,11
4301,9773,13,40,48,42,2
4302,9775,17,18,26,23,5
4303,9776,21,34,34,34,0
4304,9779,7,50,55,54,4
4305,9783,5,15,33,21,6
4306,9784,27,25,32,29,4
4307,9785,14,43,47,47,4
4308,9786,18,16,43,23,7
4309,9787,5,53,59,58,5
4310,9788,19,31,34,34,3
4311,9789,2,6,15,9,3
4312,9790,23,22,23,22,0
4313,9791,15,14,16,16,2
4314,9792,20,40,41,41,1
4315,9794,14,35,38,37,2
4316,9795,8,40,41,41,1
4317,9796,17,41,43,43,2
4318,9798,13,35,42,40,5
4319,9799,14,13,30,15,2
4320,9801,2,60,81,77,17
4321,9802,16,35,41,40,5
4322,9803,18,36,36,36,0
4323,9804,15,23,39,29,6
4324,9806,11,37,42,42,5
4325,9807,8,35,51,45,10
4326,9808,9,47,55,53,6
4327,9809,12,38,41,40,2
4328,9810,18,39,45,43,4
4329,9811,8,43,49,46,3
4330,9812,15,33,44,39,6
4331,9813,4,50,57,55,5
4332,9814,3,59,64,62,3
4333,9815,14,33,44,43,10
4334,9816,6,46,53,52,6
4335,9817,9,39,45,45,6
4336,9818,14,38,43,41,3
4337,9819,12,35,39,37,2
4338,9820,4,4,6,4,0
4339,9821,10,40,43,42,2
4340,9823,2,1,2,1,0
4341,9824,12,36,40,40,4
4342,9825,12,44,51,51,7
4343,9827,18,39,49,48,9
4344,9828,6,6,7,7,1
4345,9829,15,37,47,46,9
4346,9830,7,43,50,50,7
4347,9831,11,32,73,64,32
4348,9832,14,21,58,54,33
4349,9833,13,25,38,35,10
4350,9834,14,28,34,32,4
4351,9835,16,14,16,15,1
4352,9836,15,21,31,29,8
4353,9837,14,15,16,15,0
4354,9838,17,25,31,30,5
4355,9839,13,30,40,37,7
4356,9840,14,31,38,38,7
4357,9841,11,8,13,11,3
4358,9842,17,17,18,18,1
4359,9843,23,22,27,25,3
4360,9844,10,8,10,9,1
4361,9845,16,30,36,36,6
4362,9846,13,28,30,29,1
4363,9847,17,35,35,35,0
4364,9848,21,26,31,31,5
4365,9850,17,28,31,31,3
4366,9851,19,33,35,34,1
4367,9852,11,46,53,49,3
4368,9853,10,31,39,37,6
4369,9854,14,23,41,30,7
4370,9855,8,42,42,42,0
4371,9856,10,46,52,49,3
4372,9857,15,44,48,48,4
4373,9858,9,53,53,53,0
4374,9860,14,10,22,18,8
4375,9861,3,1,2,1,0
4376,9864,12,34,37,37,3
4377,9865,21,22,25,23,1
4378,9866,20,22,39,31,9
4379,9867,9,43,52,49,6
4380,9868,15,23,33,27,4
4381,9869,9,24,27,26,2
4382,9870,10,27,37,30,3
4383,9871,13,36,52,50,14
4384,9874,20,28,30,29,1
4385,9876,14,15,32,32,17
4386,9878,13,19,91,59,40
4387,9879,6,5,5,5,0
4388,9880,18,24,28,27,3
4389,9883,9,28,47,42,14
4390,9884,5,28,150,84,56
4391,9885,12,20,26,24,4
4392,9886,15,19,25,23,4
4393,9889,33,32,91,77,45
4394,9890,16,35,38,37,2
4395,9891,6,2,8,6,4
4396,9893,14,17,21,17,0
4397,9894,8,28,39,36,8
4398,9895,14,31,40,36,5
4399,9896,19,32,37,36,4
4400,9897,21,20,24,22,2
4401,9898,8,27,35,31,4
4402,9899,12,36,44,43,7
4403,9900,7,48,49,48,0
4404,9901,22,29,31,31,2
4405,9902,20,22,22,22,0
4406,9903,21,28,31,29,1
4407,9904,7,39,59,58,19
4408,9905,8,28,45,40,12
4409,9906,16,19,20,20,1
4410,9907,4,46,57,52,6
4411,9908,6,53,67,61,8
4412,9910,7,32,67,50,18
4413,9911,15,25,36,31,6
4414,9912,12,44,53,53,9
4415,9913,11,26,32,30,4
4416,9914,19,26,29,29,3
4417,9917,4,51,52,52,1
4418,9918,8,23,28,25,2
4419,9919,14,20,28,23,3
4420,9920,8,59,60,60,1
4421,9921,6,50,52,51,1
4422,9923,15,42,52,49,7
4423,9924,12,32,41,39,7
4424,9925,15,36,39,39,3
4425,9926,5,54,64,63,9
4426,9927,7,19,28,24,5
4427,9928,16,8,27,16,8
4428,9929,11,32,52,41,9
4429,9932,8,24,32,29,5
4430,9933,9,38,52,46,8
4431,9934,5,48,57,54,6
4432,9935,10,40,48,47,7
4433,9936,15,33,36,36,3
4434,9937,6,42,46,46,4
4435,9938,11,39,53,51,12
4436,9939,7,30,41,41,11
4437,9940,9,34,46,43,9
4438,9941,6,47,50,47,0
4439,9942,11,34,39,36,2
4440,9943,13,26,37,36,10
4441,9944,14,39,41,41,2
4442,9945,8,44,59,56,12
4443,9946,20,40,50,48,8
4444,9947,6,44,67,64,20
4445,9948,16,37,45,41,4
4446,9949,6,49,57,57,8
4447,9950,5,35,48,44,9
4448,9951,15,13,42,29,16
4449,9952,10,41,53,50,9
4450,9955,17,16,16,16,0
4451,9957,3,72,83,83,11
4452,9958,12,36,47,45,9
4453,9959,6,41,47,45,4
4454,9960,1,76,88,87,11
4455,9961,7,56,59,59,3
4456,9962,2,3,5,4,1
4457,9963,5,54,67,64,10
4458,9964,18,22,22,22,0
4459,9965,2,60,79,76,16
4460,9966,4,59,73,73,14
4461,9967,18,32,41,40,8
4462,9968,7,49,56,54,5
4463,9969,8,41,45,44,3
4464,9970,20,39,43,43,4
4465,9971,14,40,45,43,3
4466,9972,3,52,69,67,15
4467,9973,2,71,85,81,10
4468,9974,5,58,67,64,6
4469,9975,9,40,43,42,2
4470,9976,5,55,80,76,21
4471,9978,21,39,39,39,0
4472,9979,11,36,46,46,10
4473,9980,3,65,76,76,11
4474,9981,19,30,34,32,2
4475,9982,20,29,34,34,5
4476,9984,13,42,47,47,5
4477,9985,12,31,31,31,0
4478,9986,3,49,68,64,15
4479,9987,19,19,25,25,6
4480,9988,7,40,56,55,15
4481,9989,13,42,45,45,3
4482,9990,18,31,33,33,2
4483,9991,5,49,54,53,4
4484,9992,4,46,51,50,4
4485,9993,11,31,43,35,4
4486,9994,8,51,56,55,4
4487,9995,16,30,34,33,3
4488,9996,21,23,25,24,1
4489,9997,11,23,28,27,4
4490,9998,11,46,50,49,3
4491,9999,11,36,42,41,5
4492,10000,10,41,47,46,5
4493,10001,11,36,42,40,4
4494,10003,12,26,34,31,5
4495,10004,6,40,48,48,8
4496,10005,11,40,45,43,3
4497,10006,15,29,49,40,11
4498,10007,7,29,30,30,1
4499,10008,9,40,48,47,7
4500,10009,14,41,44,43,2
4501,10011,13,32,37,36,4
4502,10013,4,5,23,14,9
4503,10014,16,30,78,34,4
4504,10015,8,48,58,53,5
4505,10016,9,41,53,52,11
4506,10018,10,34,38,36,2
4507,10020,7,43,73,55,12
4508,10023,17,42,44,44,2
4509,10024,17,44,48,47,3
4510,10026,7,61,69,69,8
4511,10027,9,48,57,54,6
4512,10028,9,9,15,10,1
4513,10032,17,26,30,28,2
4514,10033,9,47,50,50,3
4515,10034,16,38,42,41,3
4516,10035,10,42,47,46,4
4517,10036,15,22,24,23,1
4518,10037,14,33,34,34,1
4519,10038,17,29,43,40,11
4520,10040,10,4,16,9,5
4521,10042,5,46,131,93,47
4522,10043,9,42,50,50,8
4523,10044,14,32,37,33,1
4524,10045,15,28,28,28,0
4525,10046,19,34,34,34,0
4526,10047,6,2,16,4,2
4527,10049,6,76,77,77,1
4528,10050,2,28,32,31,3
4529,10051,8,46,62,57,11
4530,10052,7,34,36,35,1
4531,10054,2,2,4,3,1
4532,10055,10,14,20,20,6
4533,10056,8,9,9,9,0
4534,10058,3,51,63,58,7
